# Glossary in tab-separated format -*- coding: utf-8 -*-
pearóid-duine	parrot-man
leathdhuine-leathanacanda	half-man, half-anaconda
i gcogar	in a whisper
ar tí	(i) on the track of, in pursuit of, (ii) on the point of, about to.
a oiread	so much
ag súil	expecting
faoi mar	as if
is dóigh	I suppose
Fágadh ina staic é	he was rooted to the spot
ina ainneoin	in spite of
de réir mar	according to; as far as
	^^
cs	 béarla
duine	person
ní	2. Washing
aon	one/ace
cuid	portion
maith	goodness
bliain	year
cé	quay/wharf
ceann	head
rud	thing
Gaeilge	Irish (language)
lá	day
fear	man
fad	length
áit	place
am	time
Éire	Ireland
obair	work
céad	hundred/first
taobh	side
céile	spouse/companion
mac	son
teach	house
ceart	right
scéal	story
tír	country
saol	life
bith	existence
ceist	question
deireadh	end
bean	woman
dóigh	manner/way
fios	knowledge
uair	hour/time
alt	article
pobal	community
comhairle	advice/council
aghaidh	face
súil	eye
scoil	school
roinn	division/department
teanga	tongue/language
cás	case (box); case (state of affairs)
úsáid	(1) use	 usage; (2) manner of using	 treatment; (3) Jur: use; user
leith	half/side
oíche	night
Aire	Minister
baile	town/village
lucht	people
cúrsa	course
eolas	knowledge
méid	amount
caint	talk
leabhar	book
scríobh	writing
acht	act
acht	Doubt	 uncertainty.
seachtain	week
feidhm	1. function	 use. 2. undertaking. 3. need.
lámh	hand
ceap	last
ais	axis
mí	month
ábhar	material/subject
bealach	way/path
ard	height
páiste	child
muintir	people/family
airgead	money	 silver
béal	mouth; edge (of a blade); lip
bord	table
rialtas	government
stát	state
ainm	name
athair	father
dia	god
seirbhís	service
clár	board/program
talamh	land
focal	word
tús	beginning
beirt	two people
linn	pool
contae	county
foireann	team
meas	respect
measc	1. Lit: Jumble	 confusion [see prep phrase "i ~"]
bóthar	road
cónaí	residence
ceol	music
bás	death
cur	putting
ceantar	area
údarás	(1) authority; (2) jurisdiction	 power	 right to obedience; (3) delegated power; (4) authenticity; (5) self-assumed authority; (6) authoritative body; (7) local	 public authority; (8) ecclesiastical	 civil authority.
gá	need
cluiche	game
iomlán	total/whole
cóir	justice/fairness
conradh	contract
ionad	place
uisce	(m.) (1) water; (2) body of water; (3) rain	 tears	 saliva; (4) urine; (5) water for washing; (6) various types of water (e.g.	 cold	 hot	 clean	 sweet	 hard	 soft	 etc.)
geall	1. pledge	 security. 2. wager	 bet.
oileán	island
leithéid	equal/equivalent
cuma	appearance
cúpla	couple
oideachas	education
aois	age
cineál	kind/type
inis	(1) island; (2) inse
líon	full number; complement
páirtí	1. party. 2. Associates	 followers; set	 group	 people
ball	member
lán	fullness
cúirt	1. court. 3. manor-house	 mansion. 4. courtyard
cathair	city
máthair	mother
sampla	sample
doras	door
oifig	office
timpeall	surroundings
bun	base
cos	foot/leg
dún	fort
cáin	1. Lit:(a) Law	 regulation	 rule. (b) Due	 tribute. 2. Fine	 penalty. 3. impost	 tax.
córas	system
post	job
airteagal	article
croí	heart
mórán	a lot of; plenty of; much	 many ["much" and "many" are quantifiers in English	 but "mórán" is a noun	 so functions differently grammatically	 despite being glossed with those words.]
rith	run
barr	top
Dáil	parliament
tréimhse	period
imeacht	event
cúis	reason
réir	order
deis	opportunity
áirithe	1. certainty	 surety. 2. certain quantity. 3. allotment	 portion. 4. {d'áirithe; in áirithe} allotted	 certain. 5. {in áirithe} reserved	 engaged
saothar	work
coiste	committee
aimsir	weather/time
maidin	morning
toradh	result
breis	excess
each	horse	 steed
fuil	blood
tosach	beginning
tuairim	opinion
Béarla	English (language)
láthair	site
ealaín	art
comhlacht	company
domhan	world
dán	poem
caoi	way
meán	medium
tí	1. Lit:(a) Marked line	 track.
sráid	street
gnó	business
tamall	1. Space of time	 while	 spell. 2. short loan. 3. distance.
fíor	truth
seol	sail
iarratas	1. (Act of) asking	 petitioning; begging	 importunity. 2. (formal) application
múinteoir	teacher
cara	friend
seomra	room
dlí	law
iarracht	effort
cúig	five
nós	custom
míle	mile
rí	king
slí	way/path
saor	free man
ann	(1) in phrase: in a state of being able; (2) indicates capability or fitness for a task.
fás	growth
iúl	knowledge
grúpa	group
coláiste	college
fáth	reason
treo	direction
fadhb	problem
sláinte	health
coinne	appointment
cúl	back
sagart	priest
sórt	sort/kind
cead	permission
mír	section/item
bonn	A. sole	 hoof; base	 foundation. B. coin.
íoc	payment
scéim	scheme
seans	chance
fómhar	autumn
cor	(1) turn	 turning movement; (2) agreement	 contract; guarantee	 pledge; (3) tiredness	 exhaustion; (4) lively turn (in music); lively air; (5) reel; (6) cable-stitch
cogadh	war
amhrán	song
lacha	duck
cailín	girl
gaoth	wind
céim	degree/step
bia	food
dream	crowd/group
cumas	ability
tráth	1. Hour; time	 occasion; day	 period.
clann	family
leanbh	child
leas	welfare
fonn	desire
stair	history
críoch	end
brí	meaning
cúram	care
ollscoil	university
ceannas	leadership
loch	lake
athrú	change
leibhéal	level
forbairt	development
cumhacht	power
cumann	1. (a) Friendship	 love; companionship. 3. association
toisc	reason
bád	boat
grá	love
crann	tree
ocht	eight
tacaíocht	support
páirt	part
farraige	sea
cloch	stone
comórtas	comparison. competition.
solas	light
foirm	form
teideal	title
litir	letter
gné	aspect/feature
plean	plan
suim	interest
páirc	park
beatha	life
teaghlach	family
léann	learning/study
bó	cow
mór	1. Great; much	 many. 2. Friendliness. . 3. (a) Pride	 vanity. (b) great person; proud person.
aithne	knowledge
rogha	choice
pointe	point
cuairt	visit
dath	color
im	butter
file	poet
leath	half
laghad	amount/quantity
féile	festival
uasal	(1) nobleman	 gentleman; (2) the noblemen	 the nobility of the country; (3) the good people	 the fairies
lorg	(1) mark	 print; (2) trace	 track; (3) course; (4) succession	 progeny; (5) rear	 rearguard; (6) troop	 company; (7) tracker dog; (8) land formerly cultivated; (9) fallow ridge
aontas	union
clog	clock
gníomh	action
grian	sun
freagra	answer
comhphobal	community
arm	army
buachaill	boy
dáta	date
Domhnach	Sunday [day of the week]
bán	pasture
éigean	necessity/force
amhras	doubt
lár	center/middle
píosa	piece
trácht	[so many headwords] comment
líne	line
ór	gold
seacht	seven
tráthnóna	evening
rang	class
samhradh	summer
dúchas	heritage
turas	journey
tuairisc	report
cuimhne	memory
téarma	term
cuireadh	invitation
beith	birch
riail	rule
Meiriceá	America
fógra	notice/ad
páipéar	paper
beart	action/plan
cabhair	help
sraith	series
treoir	direction
léamh	reading
tine	fire
áireamh	count
corp	body
craobh	branch
oifigeach	officer
mian	desire
cultúr	culture
siopa	shop
amharc	look/view
reacht	statute
intinn	mind
polasaí	policy
capall	horse
scannán	film
gníomhaíocht	activity
bua	victory
údar	(1) m. author	 originator; source	 origin; (2) author	 writer; (3) authority	 expert; (4) authority	 reliable evidence; (5) cause	 reason; (6) 'makings'	 as in the makings of a priest.
leaba	bed
comhalta	member
tuismitheoir	parent
deich	ten
rún	secret
teilifís	television
tagairt	reference
eagla	fear
baint	relation/involvement
garda	guard
raidió	radio
éadach	cloth/clothing
tionchar	Influence or contribution to marriage.
eagraíocht	organization
aird	attention
fáilte	welcome
aer	air
beagán	small amount
dráma	drama
caighdeán	standard
luach	value
pictiúr	picture
airgeadas	finance
coinníoll	condition
sliabh	mountain
fírinne	truth
foinse	source
ré	era
neart	1. Strength; force	 power. 2. Plenty. 3. power to prevent	 to remedy. 4. ability
comhar	cooperation
uachtarán	president
toil	will
modh	1. Mode	 manner. 2. Procedure	 method.
scríbhneoir	writer
triúr	three people
leigheas	medicine
scrúdú	exam
Nollaig	Christmas
pleanáil	planning
iontas	wonder
smaoineamh	thought
cuideachta	company
cuntas	account
creideamh	belief
aonar	individual
filíocht	poetry
baol	danger
tiarna	lord
teacht	arrival
deoch	drink
parlaimint	parliament
greim	grip
carr	1. rough surface. 2. rocky patch.
carr	car
staidéar	study
suíomh	1. Site	 location; settlement	 arrangement; establishment
dalta	pupil
faisnéis	information
costas	cost
port	tune
fianaise	evidence
droim	back
troid	fight
anam	soul
leagan	version
teagasc	teaching
cruinniú	meeting
ócáid	occasion
uimhir	(1) number; (2) numeral	 figure; (3) number in series; (4) count	 aggregate; (5) atomic number; (6) transport number; (7) size; (8) edition of a newspaper; (9) reference number; (10) telephone number; (11) singular	 plural	 number; (12) dual number; (13) even	 odd	 rational	 irrational	 composite	 real	 abstract number; (14) count of yarn
tuath	countryside
brath	[braith-VN]; 2. perception	 feeling. 3. spying betrayal. 4. brath ar (expectation	 intention; dependence)
dochtúir	doctor
ciall	sense
oidhreacht	heritage
abhainn	river
glas	lock
airde	height
foras	foundation
spéis	interest
dualgas	duty
iníon	daughter
dearmad	mistake
próiseas	process
spórt	sport
fostaíocht	employment
banc	bank
gleann	glen
litríocht	literature
polaitíocht	politics
réim	range
ráiteas	statement
iarthar	west
gnáth	custom	 usage; customary thing. 2. frequentation. 3. haunt	 resort
guth	voice
dochar	harm; hurt	 injury; loss	 distress
slua	crowd
cinneadh	decision
nuachtán	newspaper
radharc	view
cion	affection
iasc	fish
margadh	market
toghchán	election
comhaontú	agreement
diabhal	devil
socrú	arrangement
feachtas	campaign
club	club
deartháir	brother
formhór	majority
ordú	2. order. 2a. command	 injunction. 2c. normal state	 proper conditionl.
bláth	flower
nuacht	news
riachtanas	necessity
fuinneog	window
teorainn	boundary
tuiscint	understanding
taisteal	travel
malairt	change
suíochán	1. seat. 2. sitting; session
áis	1. Convenience. 2. Device; aid
ainmhí	animal
nóiméad	minute
liosta	list
caibidil	chapter
feabhas	improvement
gáir	shout
siúl	walking
carraig	rock
taca	support
trá	beach
glúin	generation/knee
stiúrthóir	director
cumarsáid	communication
maithe	goodness	 good
cnoc	hill
taighde	research
imreoir	player
aigne	mind
earra	item/article
aonad	unit
dúil	desire
saghas	kind
duais	prize
balla	wall
tábhacht	importance
oireachtas	legislature
Satharn	Saturday
comhartha	sign
mála	bag
caisleán	castle
scil	skill
saighdiúir	1. soldier. 2. Dogged	 courageous	 person.
síocháin	peace
nóta	note
taithí	experience
naoi	nine
institiúid	institution
meall	m. (gs. mill	 pl. ~ta). 1. Ball	 globe. ~ na gréine	 orb of sun. ~ súile	 eye-ball. ~ iarainn	 luaidhe	 ball of iron	 of lead. ~ sneachta	 snowball. ~ a dhéanamh de rud	 to roll sth. into a ball. 2. (a) Prominent	 fleshy	 part. ~ (coise)	 calf (of leg). Druidim an mhill	 narrowing of shank of stocking. ~ láirige	 buttock. (b) Protuberance	 projection. ~ brád	 Adam’s apple. (c) Tumour	 swelling; (pl.) mumps. ~ gorm	 carbuncle. (d)Top: Knoll	 mound. 3. Lump	 mass. ~ ime	 lump of butter. ~ ceo	 mass of fog. ~ gan chuma	 shapeless mass. ~ a dhéanamh de rudaí	 to gather things together	 in a heap. 4. ~ mór	 important person. (Agus) an ~ mór ar deireadh	 (and) last but not least.
cuspóir	purpose
stáisiún	station
vóta	(1) vote; (2) financial vote	 educational vote
glór	voice
imní	worry
gluais	vehicle
ceannaire	leader
eaglais	church
bainisteoir	manager
cathaoirleach	chairperson
eolaíocht	science
deontas	grant (as of money)
teachta	messenger
ospidéal	hospital
bille	bill
cill	church
teagmháil	contact	 communication
comhrá	conversation
foirgneamh	building
tionscal	industry
tada	2. iota	 jot	 whit	 tittle
tuarascáil	report
rialachán	regulation
cloigeann	head
paróiste	parish
aidhm	aim/goal
trua	1. pity. 2. miserable person	 wretch. 3. lean meat
gáire	laugh
cló	type/print
éan	bird
gearán	complaint
buíochas	thanks
eachtra	adventure
adhmad	"1. wood
2. material
3. rhetorical device"
poll	hole
scríbhinn	writing
spéir	sky
scór	score
milliún	million
ioncam	income
leathanach	page
ráta	rate
gaol	relation
breac	trout; fish
timpeallacht	environment
easpa	lack
galar	disease
gasúr	1. Boy. 2. Youngster	 child
deacracht	difficulty
oiliúint	2. Nutrition	 nourishment. 3. Nurture	 upbringing	 fostering care. 4. training	 coaching
caidreamh	relationship
Márta	March
iarrthóir	candidate
bosca	box
peil	football
aitheantas	recognition
traidisiún	tradition
réimse	1. stretch	 tract. 2. range	 field
Luan	Monday
ceangal	connection
caiteachas	expenditure
punt	pound
gluaiseacht	movement
poblacht	republic
beartas	policy
cath	battle
urlár	(1) floor; (2) one-storey house; (3) level surface; (4) bottom surface; (5) sill
triail	trial
seasamh	standing/position
fuinneamh	energy
béim	emphasis
tóir	pursuit
éisteacht	listening
cothrom	balance
cál	cabbage
bainistíocht	management
fostaí	employee
brú	pressure
taifead	record
bunscoil	primary school
eas	waterfall
saothraigh	(1) of saothrach
scoláire	scholar
léiriú	1. [léirigh-VN]. 2. representation	 clarification	 illustration
binn	peak
Aibreán	April
éifeacht	effect
buille	blow
dóthain	enough	 sufficiency
máistir	master
tor	A. bush	 shrub. B. tall rock; tower
croch	cross/gallows
fórsa	force
ord	order
comhdháil	conference
taoiseach	prime minister
madra	dog
seilbh	possession
óige	youth
laoch	hero
sliocht	descendant	 offspring
comhairleoir	counselor
fine	kin
long	ship
gloine	glass
breithiúnas	judgment
craiceann	skin
cosc	prohibition
tionscadal	project
iasacht	loan
iamh	confinement
leasú	amendment
limistéar	area
Eanáir	January
cósta	coast
babhta	round
éileamh	demand
ionsaí	attack
ionadh	wonder
teas	heat
méad	quantity
aíocht	milk
tionscnamh	2. Beginning	 origin; introduction	 initiation; institution	 establishment.
cóip	copy
tae	tea
cáilíocht	qualification
rás	race
bróg	shoe
breith	birth
cruth	shape/form
áthas	joy
tuilleadh	"Act of adding	 increasing
Addition	 increase
More (in various contexts)"
téacs	text
muir	sea
taispeántas	exhibition
feirm	farm
seal	time/period
struchtúr	structure
iris	magazine
príosún	prison
smacht	control
muc	pig
halla	hall
ealaíontóir	artist
agallamh	interview
réiteach	solution
féar	grass
comhthéacs	context
ról	role
eol	m. (gs. eoil). 1 = eolas. 2 = iúl. 3. (With copula) Is ~ dom (go)	 I know (that). Is ~ do chách	 don saol	 (go)	 everyone knows (that). Mar is ~ duit	 as you know. Déan é mar is ~ duit	 do it as best you know. Ní h~ dó a athrach	 a mhalairt	 he knows no better.
iompar	transport
feirmeoir	farmer
cosúlacht	likeness
faitíos	"1. Fear	 apprehension.
2. Timidity	 shyness."
saoire	holiday
póca	pocket
comhluadar	company (companionship)
dóchas	hope
teannta	strait	 difficulty	 predicament; (2) prop 	support (3) foothold	 grip
gléas	"A. glaze	 gloss.
B. 1. Order	 adjustment	 arrangement. 2. device"
léitheoir	reader
náisiún	nation
bréag	lie
gunna	gun
bus	bus
carn	heap
fán	2. straying	 wandering vagrancy. 3. turning aside. 4. sparsity
caora	sheep
infheistíocht	investment
planda	plant
ceadúnas	license
coimisinéir	commissioner
moill	delay	 stop	 hindrance
cine	kind/type
déanaí	lateness
stiúir	helm
spás	space
cnámh	bone
rabh	saw
bainne	milk
druga	drug
cárta	card
Críost	Christ
son	pleasure
achar	distance
ubh	(f.) (1) egg; (2) hen's egg	 goose's egg	 duck's egg; (3) seagull's egg	 sparrow's egg; (4) boiled egg; (5) soft-boiled egg	 hard-boiled egg; (6) poached egg; (7) scrambled egg; (8) shell-less egg; (Var: m.)
polaiteoir	politician
ollamh	professor
cúige	province
uachtar	cream
comparáid	comparison
séipéal	chapel
gruaig	hair
gort	field
deirfiúr	sister
Aifreann	mass
ríocht	kingdom
praghas	price
glacadh	[glac-VN] 2. acceptance. 3. handling	 grasping	 seizure
reachtaíocht	legislation
oibriú	[oibriú-VN] 2. working; operation	 activity.
geimhreadh	winter
léargas	insight
iarraidh	request
muinín	trust
curaclam	curriculum
buidéal	bottle
ae	liver.
easpag	bishop
fostóir	employer
stádas	status
sruth	stream
abar	bog.
díospóireacht	debate
pearsa	person
feoil	meat
droichead	bridge
breitheamh	judge
tábhairne	tavern/pub
táille	fee/fare
cat	cat
locht	fault
éadan	front
móin	peat
meon	"Mind	 disposition
Character	 temperament
Spirit of the age"
rúnaí	secretary
réigiún	region
slat	rod
cros	cross
difríocht	difference
mainistir	monastery
dearcadh	Sorrow	 grief
Feabhra	February
úrscéal	(m.) (1) novel;
staid	State
corn	horn
dúiche	Duke
scéala	Story	 news
prionsabal	principle
rian	Path	 track
blas	Taste
ceathrar	four
tréith	trait
lear	"    { ""word"": ""lear 1""	 ""overview_definition"": ""(noun) sea or ocean; (adverb) across or beyond the sea	 overseas.""}	
    { ""word"": ""lear 2""	 ""overview_definition"": ""(noun) defect or failing; shortcoming.""}	
    { ""word"": ""lear 3""	 ""overview_definition"": ""(noun) great number or amount.""}"
aiste	essay.
eacnamaíocht	economics
scoth	(noun) flower or blossom; (noun) choice or pick; (noun) tuft or bunch; (noun) bundle or sheaf; (noun) algae; (noun) arrangement or cut; (noun) point or tip; (noun) projection or ridge; (noun) chip or splinter; (noun) branch of family; (noun) speech or utterance; (noun) air or tune; (prefix) semi- or medium-; (prefix) tufted.
ola	oil
brón	sorrow
draíocht	Magic	 enchantment
liúntas	Flattery
tóin	bottom
deisceart	south; southern part
cathaoir	chair
druid	Druid
traein	train
ciste	fund
téama	theme
aisteoir	actor
leabharlann	Library
traenáil	Train (as in railway)
abairt	sentence
sochar	Benefit	 advantage
cluais	Hear
ocras	Hunger
fáil	Opportunity	 chance
báisteach	rain
soláthar	supply
déanamh	To do	 make
faoiseamh	Relief
stán	Dung	 excrement
bráthair	brother
eagarthóir	Editor
dícheall	best endeavor
rá	Speech	 talk
cíos	rent
éag	Lack	 shortage
daonra	Population
ionadaí	representative
póilín	Penny
nasc	Link	 connection
gradam	Grade	 level
maígh	Midge (a small fly)
boladh	smell
gnóthach	Busy
trádáil	Trade
arán	bread
deoir	tear
ceathrú	quarter
tógáil	Construction
spiorad	Spirit
sonra	detail
cainteoir	speaker
croith	Frost
caitheamh	Clothing
drámaíocht	drama
tobar	well
sábháil	Preservation
dear	Pure	 chaste
comharsa	neighbor
crom	Bent	 crooked
buntáiste	Benefit
rannóg	Section	 part
léim	jump
eagras	organization
pósadh	Marriage
béile	meal
cré	clay
bearna	gap
magadh	mockery
suí	(noun) a sitting position; (noun) a state of being arisen; (noun) a session; (noun) a seat or location; (noun) a situation or position; (noun) squatting or encampment; (noun) a hen sitting on eggs; (noun) a determined state; (noun) letting of land or houses; (noun) buttocks.
aistriúchán	translation.
coill	forest
bolg	Spear
óstán	hotel
maoin	Wealth	 property
iomaíocht	Competition
scar	Scar
mullach	Summit
leithscéal	excuse
achan	(noun) every one; (noun) each.
ceoltóir	musician
coitinne	Evening
earnáil	Sector	 area
náire	shame
bunús	Foundation
amárach	Tomorrow
pinsean	Penance
ionannas	Equality
tromlach	Greater part	 main body	 majority.
rinn	point
sách	(noun) a well-fed person;
moladh	Praise
scáth	shadow
Samhain	(Proper Noun - Festival)
fíon	wine
fód	sod
leathnaigh	Half-grown
cladach	seashore
dian	Sharp	 fierce
ára	Price
fiacail	tooth
raon	Range
ádh	luck.
barúil	opinion
sos	break
bunadh	Growth	 increase
séan	Old
síol	seed
méadú	Increase
craol	Draught	 draft
marc	mark
sinsear	Ancestor
imeall	border	 edge
íomhá	1. image	 statue. 2. likeness	 representation	 reflection.
Íosa	Jesus
othar	patient
saibhir	Wealthy
taithigh	Journey
gualainn	shoulder
béaloideas	Folklore
tríocha	Thirty
uirlis	(f.) (1) tool	 implement
codladh	sleep
iascaireacht	Fishing
aicme	1. Genus; class. 2. Family	 tribe. 3. Set	 clique. 4. Mth: Denomination.
monarcha	factory
staighre	Station
fiontar	venture
fuaim	sound
teicneolaíocht	technology
cúinne	corner
machnamh	Reflection	 thought
amharclann	Cinema
caomhnaigh	To cultivate
gairm	profession
cistin	kitchen
iarann	Iron
seanchas	Tradition	 lore
straitéis	Strategy
Déardaoin	Thursday
tost	Toast
tuarastal	salary
sochaí	Society
iriseoir	Journalist
cúnamh	Help	 assistance
gealach	Moon
olltoghchán	University student
asal	donkey
turasóireacht	Tourism
leanúint	(noun) following	 pursuit	 adherence	 continuation; 
inne	Oven
báire	Mirror
Protastúnach	Protestant
coimhlint	race	 contest; rivalry	 competition
dearbhú	Confirmation
pá	Peer	 lord
ucht	(1) m. chest	 breast	 bosom; (2) lap; (3) upper front; (4) to set about doing something; (5) for the sake of	 on account of; (6) facing	 in face of; (7) in front of	 before	 in anticipation of.
aithris	narration.
trioblóid	Trouble
óglach	Recruit
fairsing	Generosity
aill	cliff
earrach	spring
todhchaí	Future.
ceird	craft; trade	 skill
achomharc	appeal.
aos	1. People	 folk. 
riarachán	Carriage
maolaigh	Uncanny
slándáil	Safety	 security
greann	Humor
briathar	verb
Críostaí	Christian
tairbhe	Benefit
cúiteamh	Tribute
geata	gate
doiciméad	Document
íocaíocht	payment
tíor	Wild animal
damhsa	dance
pioc	Pick
beannaigh	Blessing
talmhaíocht	Herbalism
liath	Grey
Albain	Scotland
namhaid	enemy
léitheoireacht	Reading
ceacht	lesson
sásaigh	To kiss
maide	Stick	 bar	 beam.
carachtar	character
tithíocht	Housing
claí	hedge
oirthear	South-west
stór	Treasure
bunreacht	constitution
saoránach	citizen
ciontach	Precious
iomarca	Abundance
bruach	bank (of a river)
táirge	product
triall	Traffic
éagsúlacht	Diversity
tuar	sign; omen
uaigh	grave
feidhmeannach	Functional
rath	Prosperity
méar	finger
cuntais	County
eagrán	Edition
faic	Vision
póg	kiss
tiomáin	Carriage
scairt	Scarf
cruinne	World
suaimhneas	Peace
pingin	penny
tart	Sour
láithreán	Site	 location
pléasc	Arena
gairdín	garden
freagracht	Responsibility
cluin	Ear (dialect)
cosaint	Protection
acmhainn	1. Capacity	 endurance. 2. means	 resources
sneachta	Snow
dabht	Doubt
braon	1. drop. 2. pus.
ceal	Veil
fáinne	ring
bail	Court	 jurisdiction
uafás	Panic
figiúr	figure
reifreann	Referee
mothúchán	Emotion
tráigh	Strand	 beach
tábla	table
plé	Discussion
lón	Lunch
urlabhra	(1) faculty of speech	 speech	 utterance; (2) manner of speech	 diction
folach	Hidden
sábháilteacht	Safety
tréan	Strong
banna	Window
sprioc	Goal	 target
cairt	Card
aonach	fair
ualach	(1) load	 burden; (2) horse-load; (3) back-load; (4) load of hay	 coal	 sand; (5) burden of sorrow	 care; (6) no encumbrance; (7) in mechanics	 load.
reilig	cemetery
áitreabh	Library
cluas	ear
binse	Bin	 trash can
anáil	breath
leataobh	To lie down
art	Art
neamh	Heavenly
fiosraigh	To investigate
nádúr	Nature
contúirt	danger
colainn	body (living)
lom	Pale	 faint
tonn	wave
cosán	path
ardán	stage/platform
séid	Seaweed
néal	cloud
feadh	Duration
gréasán	1. Web.
grianghraf	photograph
séasúr	season
dromchla	top	 ridge	 crest; (raised) surface
fearg	(noun) anger; (noun) irritation; (noun) elemental fury.
ceo	mist
cúlra	(noun) background; (noun) ground(work) in painting or tapestry.
aisce	favor.
áras	(noun) a habitation or abode; (noun) a house or building; (noun) a vessel; (noun) refers to the uterus or womb.
cnuasach	collection
meánscoil	secondary school
ríomhaire	(noun) a counter or enumerator; a calculator; a computer.
clú	fame
tinneas	illness
peann	pen
donn	(noun) brown (colour)	 a brown animal	 hard brown timber;
sceideal	(noun) a plan or timetable for events; (noun) a flurry or excitement.
Gaeilgeoir	Irish speaker
seoladh	(noun) a form of sailing or sail; (noun) course or direction; guidance; (noun) opening statement; (noun) address; (noun) conduction; (noun) guide.
teastas	1. (literary) testimony. 2. testimonial	 certificate. 3. report	 reputation.
srian	bridle
pian	pain
uaigneas	(noun) loneliness or solitude; (noun) a lonely place; (noun) state of being alone; (noun) feeling of loneliness; (noun) fear of being alone or the dark; (noun) seclusion or privacy.
clúdach	cover
coinbhinsiún	(noun) a convention.
gair	(noun) a call or shout
gin	(noun) begetting or birth; (noun) foetus; (noun) procreated being	 child	 or offspring; (noun) generating source;
dinnéar	dinner
cian	(noun) length of time or age; (noun) distance or distant place; (noun) sadness or melancholy; (adjective) long; (adjective) distant; (prefix) indicating long or remote.
aréir	(adverb) last night; (noun) refers to the previous night; (adjective) used in expressions related to the previous night.
úinéir	(m.) (1) owner; (2) proprietor
saibhreas	(noun) riches or wealth; (noun) richness	 as in the richness of soil or minerals.
duilleog	(noun) a leaf; specifically	 it can refer to leaves of trees	 hats	 tables	 tea	 tobacco	 seaweed	 or books.
aice	proximity	 lobsterhole.
claon	inclination
teampall	temple
míchumas	(noun) inability or incapacity; (noun) total disablement; (noun) disability in legal context.
gorta	(noun) hunger or famine; (noun) meanness or niggardliness.
fiach	1. debt. 2. offence. 3. cost	 price. 4. obligation.
cóta	coat
custaiméir	customer
cleachtas	(noun) practice; (noun) the practice of the courts.
dlúth	(noun) a term for warp in weaving
caoga	fifty
leacht	1. grave	 grave-mound. 2. memorial cairn. 4. heap	 mound; large amount
leacht	liquid
cluain	meadow
admháil	confession
scéalaí	storyteller
culaith	suit
manach	(noun) a monk; (historical) a tenant of church land.
cleachtadh	(noun) a form of habit or custom; (noun) practice or experience in a skill; (noun) rehearsal; (noun) exercise.
tráchtáil	(noun) act of trading; trade	 commerce.
géag	branch/limb
míniú	(noun) explanation or interpretation; (verb) the verbal noun of mínigh.
taisce	(noun) a store or treasure; (noun) a storehouse or treasury; (noun) a deposit	 such as in a bank; (term of endearment) a term of affection meaning 'my dear'.
goid	(noun) theft or larceny; (verb) to take away or remove; to steal something from someone.
cuan	harbor
argóint	argument
éad	(noun) jealousy; envy	 emulation; (verb) to be jealous of someone.
spraoi	(noun) fun or sport; (verb) to play or have fun.
leictreachas	(noun) electricity.
cáipéis	document
leis	(noun) thigh; (noun) leg	 haunch; (adverb) also; (adverb) too	 either; (adverb) uncovered	 exposed.
cách	(noun) everyone; (noun) being	 person.
inneall	(noun) arrangement or adjustment; (noun) furnishings or attire; (noun) proper state or condition; (noun) contrivance or trap; (noun) machine or engine.
inmheánach	(noun) inner parts of the body;
athuair	(noun) a second time;
jab	(noun) a job or piece of work; (noun) employment or post.
péire	"péire1	 m. (gs. ~	 pl. -rí). Pair. 1. ~ bróg	 lámhainní	 piostal	 pair of shoes	 of gloves	 of pistols. ~ capall	 pair of horses (in harness). Cuir ina bpéirí iad	 arrange them in pairs. Ní ~ a chéile iad	 they are not a pair. 2. (Of persons) Is deas an ~ iad	 they make a nice pair. Péirí a dhéanamh	 to pair off.
péire2	 m. (gs. ~).Milt.
péire3	 m. (gs. ~	 pl. -rí). Pear."
lóistín	accommodation
buiséad	(noun) a financial plan or budget;
taitneamh	(noun) shine or brightness; (noun) liking or enjoyment.
teachtaireacht	(noun) a message or errand;
foclóir	dictionary
cruach	stack
rince	dance
pápa	(noun) the Pope.
pota	pot
dúchasach	(noun) a hereditary proprietor or head of a community; (noun) a hereditary follower; (noun) a native or inhabitant;
cearnóg	square
sil	(noun) a drip or trickle;
barra	bar
léarscáil	(noun) a representation of an area	 typically showing geographical features; (noun) a wall-map; (noun) a grid-map; (noun) a road-map; (noun) a contour map; (noun) a skeletal map; (noun) the map of the world.
páirtíocht	(noun) partnership; fellowship	 association; (phrase) for my part	 as far as I am concerned.
bailiúchán	(noun) a collection; (noun) an act of gathering.
cearc	hen
or	(noun) a prefix used to denote something original or primary;
sráidbhaile	(noun) a village.
gás	(noun) a substance in a gaseous state; (noun) paraffin oil.
banríon	queen
Giúdach	(noun) a Jew; (adjective) Jewish.
casadh	(noun) a twist or turn; (verb) to twist or turn something.
tapa	(noun) quickness	 readiness	 speed; (adjective) quick	 ready	 active.
fríd	(noun) a flesh-worm or mite; a diminutive thing or the least little bit of something; (noun) a faint smile.
arb	(noun) a term used in Irish slang	 often referring to a person or a thing in a casual or informal context.
scuab	(noun) a besom or broom; (noun) a brush for various uses; (noun) a sheaf or bundle; (noun) a sweeping gust of wind; (verb) to sweep or clean a surface.
eastát	(noun) an estate	 particularly in legal or historical contexts; refers to types of estates such as personal	 real	 or qualified.
saineolaí	expert
beannacht	blessing
árachas	(noun) insurance; (noun) includes types such as unemployment	 fire	 life	 health	 accident	 and marine insurance; (verb) to insure something	 such as a house or one’s life; (phrase) faoi árachas means insured.
aoi	guest
liathróid	ball
dual	(noun) a lock or tress of hair; (noun) a wisp or tuft	 such as of flax or wool; (noun) a ply or strand	 like a strand of thread or rope; (noun) a twist or twine	 as in twining a cord; (noun) a spiral or whirl	 like a smoke spiral; (noun) a dowel; (noun) a knot in timber; (adjective) native or natural	 as in what is expected of someone; (adjective) proper or fitting	 referring to rightful place or inheritance; (adjective) in the natural order of things	 fated or possible; (verb) to twine	 braid	 coil	 interlace	 or fold.
ceardchumann	union
fón	(noun) a device used for communication over distances	 commonly known as a telephone.
práta	potato
saoirse	(noun) craftsmanship	 workmanship	 art; (noun) freedom	 status of freeman	 nobility; liberty	 independence; immunity	 exemption; privilege; honorary privilege; cheapness	 inexpensiveness.
captaen	(noun) a captain.
naomh	saint
brat	cloak
díon	(noun) protection or shelter from elements and harm
íochtar	lower part
samhlaíocht	(noun) the faculty of imagining or forming new ideas.
sinsearach	(noun) a senior person; (noun) an ancestor; (adjective) senior; (adjective) ancestral.
éide	(noun) clothes or clothing; (noun) distinctive dress or vestments; (noun) historical term for armour or panoply.
dall	blind person
mín	(noun) a smooth	 fine thing or part; (noun) smooth	 level land or tract of grassland; (adjective) smooth with an even surface; (adjective) polished or smooth to touch; (adjective) free from wrinkles or hair; (adjective) not harsh; (adjective) soft and delicate; (adjective) flowing; (adjective) suave or plausible; (adjective) fine or small; (adjective) gentle or courteous; (adjective) quiet or still.
coincheap	(noun) a concept; (verb) to conceive.
freastal	(noun) attendance or service; (verb) to attend to work or help someone; (noun) attendants or helpers; (noun) school attendance; (phrase) to provide enough for one's needs; (phrase) to deal with someone.
amhránaí	singer
ardú	(noun) elevation; (noun) horseshoes; (noun) increase; (noun) exaltation; (noun) excitement.
meáchan	1. weight
tiománaí	(noun) a driver; specifically	 a cattle-driver or a driver of a bus or engine; also refers to a golf driver.
dorchadas	(1) darkness; (2) secrecy	 reserve
cleas	trick
gabháil	(1) catch	 seizure	 capture; (2) assumption of authority	 occupation of territory; (3) acceptance; (4) undertaking; (5) conception; (6) tolerance; (7) armful of hay	 turf; (8) fitting	 adjustment; (9) yoke	 harness; (10) attire; (11) control; (12) prop	 support; (13) rendering	 singing; (14) barm	 yeast	 leaven.
garraí	garden/field
portach	bog
iascaire	fisherman
meabhair	mind
meascán	(1) mass	 lump; (2) mixture	 jumble	 muddle; (3) bewilderment	 confusion; (4) hallucination
coiscéim	step
patrún	(1) pattern; (2) model; (3) sample; (4) design; (5) example
coir	crime	 offence; fault	 transgression.
seó	show
dlíodóir	lawyer
luas	(1) speed	 velocity; (2) earliness
cúigear	(1) five; (2) five men	 women	 children; (3) five of them	 of the neighbours; (4) five of the sheep are lost; (5) how many (things) are there? Five.
árasán	apartment
paidir	prayer
buairt	sorrow	 vexation
aisling	vision; vision poem
miotal	(1) metal; (2) hard	 solid material; (3) mettle	 spirit; (4) hardihood
armas	(1) arms; coat of arms; (2) protective shield	 protection
scéalaíocht	storytelling
peaca	sin
snáithe	thread
eitleán	airplane
ómós	homage	 reverence	 or respect	 often expressed in honor of someone or something.
idé	(1) idea
buaiteoir	winner
taise	(1) dampness	 moistness	 humidity; (2) softness	 smoothness	 tenderness; (3) mildness	 gentleness	 kindness	 compassion; (4) weakness	 faintness; (5) fetch	 wraith; (6) shade	 apparition	 ghost; (7) remains	 relics; (8) ruins.
creidmheas	(1) credit; (2) letter of credit; (3) credit balance
scála	scale
Cáisc	Easter
fiosrúchán	(1) act of inquiring	 inquisition; (2) court of inquiry
teileafón	(1) telephone
gaineamh	(1) sand; (2) quicksand; (3) blown sand	 drifting sand
ciorcal	(1) circle; (2) vicious circle; (3) auxiliary circle; (4) circle of similitude; (5) nine-point circle; (6) circle of inversion
uncail	(m.) (1) uncle; (gs.) ~	 (pl.) ~í
athbhreithniú	(1) review	 revision
onóir	honor
buile	madness
áilleacht	beauty.
coirce	oats
scamall	cloud
fuacht	cold
agóid	protest
beithíoch	beast; large animal; cow
troigh	foot
coicís	fortnight
cailleach	hag
aistear	journey.
eagar	order
ceapachán	appointment
eolaí	scientist
fána	1. Downward slope	 declivity
sáil	heel
ciúnas	stillness
réalta	star
samhail	(1) likeness	 semblance	 similitude; (2) image	 effigy	 representation	 model; (3) phantom	 spectre
ceardlann	workshop
seandálaíocht	archaeology
cupán	cup
buíon	band
fealsúnacht	philosophy
leac	 1. Flat stone or rock; flagstone	 slab.
béas	custom/manners
daichead	forty
cigire	inspector
éacht	achievement
eite	wing
scian	knife
pláta	plate
cú	hound
ithir	earth/soil
airí	symptom.
áth	ford
canúint	1. Speech	 expression. 2. Vernacular	 dialect. 3. Accent	 mode of pronunciation. 
cíor	comb
lánúin	couple
riocht	1. Form	 shape	 guise
aerfort	airport
scáil	shadow
eireaball	tail
bagairt	threat
teoiric	theory
úll	(1) apple; (2) fruit resembling apple; (3) the forbidden fruit; (4) Adam’s apple; (5) ball joint; (6) globular object	 ball; (7) golden apple	 precious thing; (8) tutsan.
daor	slave
bomaite	(1) moment; (2) minute
tomhas	(1) measure; (2) gauge; (3) dimensions; (4) quantity; (5) system of measurement; (6) guess; (7) riddle
strainséir	stranger
crith	shiver
mil	honey
príomhoide	Principal (teacher).
ál	brood
teist	(1) witness; (2) testimony; (3) report; (4) record; (5) recommendation; (6) reputation; (7) fame
muineál	(1) neck; (2) long neck; (3) neck of mutton; (4) neck of dress; (5) neck of land	 isthmus
sciathán	(1) wing; (2) side	 extension; part	 piece; (3) arm; (4) wicker-work lid or panel
léirmheas	1. Critical consideration	 complete assessment. 2. Criticism	 critique	 review.
gníomhaireacht	(1) activity; (2) agency
bráid	throat/neck
léine	shirt
scata	group
flaitheas	(1) rule; (2) sovereignty; (3) kingdom; (4) realm; (5) heaven
giota	bit
réabhlóid	revolution
bruscar	(1) crumbs; (2) fragments; (3) refuse; (4) rubbish; (5) rabble
sochraid	(1) body of friends; (2) host; (3) multitude; (4) allies; (5) forces; (6) funeral; (7) funeral procession; (8) cortege
timpiste	(1) accident; (2) mishap
bialann	restaurant
scair	(1) share; (2) layer	 stratum; (3) overlap; (4) spreading-ground
toirt	(1) mass; (2) volume; (3) bulk; (4) size; (5) form; (6) shape; (7) body
amadán	fool
foréigean	(1) violence; (2) force; (3) compulsion
tríú	(1) third; (2) third part
stailc	(I) (1) stubborn trait	 sulk	 sulkiness; (2) strike; (3) hunger-strike; (II) (1) starch
scread	scream
imshaol	(1) environment
cuil	(I) (1) fly; (2) may-fly; (3) caddis-fly; (4) bluebottle; (5) black fly; (6) green-fly; (7) fruit fly; (II) (1) angry appearance
bronntanas	gift	 present
ga	(I) (1) spear	 dart; (2) dart	 sting; (3) ray; (4) radius; (5) suppository; (6) gaff. (II) (1) panting	 gasping for breath
tubaiste	a significant negative event such as a calamity	 disaster	 or tragedy.
ara	(I) (1) charioteer; (2) attendant	 horseboy; (II) (1) temple
roth	wheel
seachtó	(1) seventy; (2) seventy persons	 houses
tarraingt	(1) pull	 tug; (2) drag	 haul; (3) drawing	 extraction; (4) potentiality to draw; (5) draught	 suction; (6) stretch; (7) (of speech) drawl; (8) stroke; (9) drawing	 delineation; (10) attraction	 lure; (11) withdrawal; (12) short sedge-like grass
gearrscéal	(1) short story
bratach	flag
easnamh	(1) want; (2) deficiency; (3) shortage; (4) deficit; (5) omission
léacht	lecture
sásamh	(1) satisfaction; (2) gratification	 pleasure; (3) reparation	 atonement; (4) revenge
dealbh	"statue	 figure
Deilbh: Frame	 figure	 or appearance; can also refer to the warp in weaving."
bóithrín	(1) dim. of bóthar; (2) country lane	 boreen
soir	
maighdean	(1) maiden	 virgin; (2) mermaid; (3) Virgo; (4) barren cow
faraor	(1) alas; (2) woe
cogar	(1) whisper; (2) secret	 conspiring talk
hata	hat
seisear	(I) (1) six men	 women; (2) the six of us; (3) relationship in the third degree; (II) (1) how many (things) are there? Six.
oibrí	worker
cinniúint	fate
muise	
campa	(I) (1) camp; (2) tent; (II) (1) followers; (2) faction;
clochán	(I) (1) stepping-stones; (2) (Old) stone structure; (3) stony ground;
bothán	(I) (1) diminutive of both; (2) shanty	 cabin; (3) hut	 shed	 coop; (4) game of house;
tairiscint	1. offer	 bid.
bradán	salmon
foghlaimeoir	learner
srón	nose
caipín	cap
béic	scream
scríob	1. A scrape or scratch. 2. A stroke	 effort	 or spell. 3. A marked-off limit or goal. 4. A rush or dash. 5. Stress of weather or storm.
véarsa	(1) verse; (2) stanza; (3) verse (in a broader sense)
pas	passport
bos	palm
soitheach	vessel. 1. container	 dish. 2. ship. 4. barrel	 cask
fál	hedge
eochair	key
rothar	bicycle
turasóir	tourist
lios	1. (a) Enclosed ground of (ancient) dwelling-house; enclosed space	 garth. (b) Ring-fort. (c)F: Fairy mound. 2. Ring	 halo.
cléir	clergy
uillinn	(1) elbow; (2) elbow-shaped bend	 corner	 angle; (3) angle in mathematics
nead	nest
lann	blade
rann	part
bríste	trousers
stoirm	storm
ógánach	(a) youth	 young man
coinneal	candle
briseadh	[VN] bris. 1. break. (also break as in "take a break"	 "briseadh a thógáil")
lámhscríbhinn	manuscript
bá	2. drowning. 3. immersion	 inundation.
bá	bay
dialann	diary
pionta	pint
achrann	strife	 quarrelling.
méadar	meter
iontráil	entry
brionglóid	dream
aireacht	ministry.
léaráid	diagram
aighneas	argument.
athbheochan	revival
urchar	(m) (1) cast	 shot; (2) cast of stone	 of spear; (3) gunshot	 pistol-shot; (4) cast of dice; (5) throw of shuttle (in loom); (6) a good shot	 has a good aim; (7) fairy dart
botún	mistake
píopa	pipe
toitín	cigarette
fathach	giant
uan	(1) lamb; (2) Paschal lamb; (3) the Lamb of God; (4) froth	 foam; (5) foam of wave	 of river
bata	stick
conspóid	controversy
coróin	crown
aingeal	angel.
deamhan	demon
óráid	speech
bricfeasta	breakfast
grád	grade
cró	"an opening	 ring	 or enclosure	 often with a connotation of a small	 confined space.
1. Eye	 socket. 2. Bore. 3. Aperture. 4. Ring. 5. Mechanical component. 6. Enclosure	 fold. 7. Outhouse. 8. Mean dwelling	 hovel. 9. Hollow."
baintreach	widow
glao	call
lasair	flame
banaltra	nurse
aistriú	translation.
deifir	haste
faill	(I) (1) Negligence; (2) Unguarded state; (3) Chance	 opportunity; (4) Time	 occasion; (5) Cessation	 easement.
dlínse	(I) (1) jurisdiction
scáthán	mirror
moille	(I) (1) Slowness; (2) lateness;
glaoch	(I) (1) a call; (2) a demand for goods; (3) a claim on one's time.
neamhspleáchas	independence
tarbh	bull
túr	tower
gramadach	(science of) grammar
giolla	boy/servant
plúr	(I) (1) flour; (2) flower; (3) (plúr ruibhe) flowers of sulphur; (4) (plúr carraige) rock flour.
múnla	mold
muileann	mill
ailtireacht	architecture.
méara	(I) (1) mayor.
coiteann	(I) (1) commonalty; (2) community; (3) common (of land).
créatúr	(I) (1) created thing; (2) expression of sympathy for a poor thing; (3) contemptuous term for a good-for-nothing creature.
leithreas	toilet
brabús	(I) (1) profit; (2) advantage.
fíric	(I) (1) fact.
buama	bomb
móid	(I) (1) vow; (2) (móideanna baiste) baptismal vows; (3) (móid gheanmnaíochta) vow of chastity; (4) (móid chrábhaidh) monastic vow; (5) (Briathar móide) pledged word.
sliogán	shell
crios	belt/zone
grán	grain
dífhostaíocht	unemployment
oide	teacher
misean	mission
caladh	quay
luch	mouse
comrádaí	comrade
acra	1. Tool	 implement. acraí tí	 household utensils. 2. Service	 convenience. 
acra	acre
gadhar	hound
coirnéal	corner/Colonel
staraí	historian
cáis	cheese
sceach	bush
friotal	Speech	 expression	 utterance.
eangach	net
sionnach	fox
macalla	echo
éagóir	injustice
prionsa	prince
mallacht	curse
ceolchoirm	concert
beairic	barracks
seanfhocal	proverb
oileánach	islander
léachtóir	lecturer
scáileán	screen
rón	seal
gnás	custom	 usage
gadaí	thief
téad	rope
sioc	frost
orlach	inch
fréamh	root
príomhchathair	capital (city)
scoláireacht	scholarship
airgeadra	currency.
iarsma	relic
ainmfhocal	noun
taoide	1. tide. 2. time	 spell.
cliabh	chest (of body)
meangadh	smile
faiche	green/field
deatach	smoke
gúna	gown/dress
piléar	bullet
aturnae	attorney
fia	deer
sealbhóir	occupier; possessor	 holder	 occupant
searmanas	ceremony
leid	clue
ailse	cancer.
canna	can
cnaipe	button
leabhrán	booklet
boc	buck
intleacht	intellect (noun)
cumha	sorrow
aeráid	climate.
caife	coffee
lipéad	label
lus	herb
ráfla	"1. (Act of) warbling	 singing; chattering	 gossiping. 
2. Rumour	 report."
acadamh	academy.
garsún	boy
siúlóid	walk
seic	check
cuach	cuckoo
cléireach	clerk
ab	abbot.
airne	sloe	 gland.
altóir	altar
coileach	rooster
treibh	tribe
crúb	hoof
eisceacht	exception
bacach	lame person
pléisiúr	pleasure
gé	goose
rabhadh	warning
slabhra	chain
cleite	feather
dámh	faculty
coinín	rabbit
beach	bee
nimh	poison
osna	sigh
achtachán	enactment.
paisinéir	passenger
iarnród	railroad
aintín	aunt
pluais	cave
bainis	wedding
naíonán	infant
taibhse	ghost
aisíoc	repayment.
geis	geis (taboo)
gealltanas	promise
ceapaire	sandwich
aoibh	1. Lit: Form	 beauty. 2. Smile; pleasant expression
sicín	chicken
inchinn	brain
foilsitheoir	publisher
fásach	desert
léiritheoir	producer
taom	fit/attack
eala	swan
fraoch	1. Heather. 2. heath	 moor
forás	growth
adharc	horn. 4. Peak. 6. erection
péintéir	painter
masla	insult
caillteanas	loss
cónra	coffin
coinsias	conscience
míol	animal
maor	steward
goile	1. stomach. 2. appetite
anraith	soup
neacht	niece
cith	shower
lúthchleas	athlete
cruachás	Predicament; difficulty	 distress. 
ceirnín	record
girseach	girl
uacht	will (legal)
peata	pet
foraois	forest
ministir	minister
peileadóir	footballer
mias	"1. Lit:(a) Board	 slab; table. (b) Altar-slab	 altar. 2. (a) Dish. ~ chré	 earthenware dish. ~ phióige	 pie-dish. (b)Cu: Dish. ~ oisrí	 dish of oysters. Fuair sé ar a mhias féin é	 it was dished out to him; he was told off in no uncertain terms. (c) Shallow basin. ~ bhainne	 basin of milk; milk cooler. 3. Phot:~ fosaithe	 fixing bath. ~ réalta	 developing tray.

laige	weakness
cliant	client
siúr	1. Sister, kinswoman
cnó	nut
pátrún	patron
scaif	scarf
seanathair	grandfather
ascaill	armpit
draoi	druid
draoi	Great number or amount.
cúntóir	assistant
laoi	lay, (narrative) poem
dair	oak
siocair	cause or excuse
péist	worm
féasta	feast
píobaire	piper
scilling	shilling
racht	fit/fit of emotion
dúthracht	1. Devotion, fervour; earnestness, diligence. . 2. Goodwill; goodwill offering, favour
uaimh	cave
casóg	coat/jacket
achoimre	summary.
foscadh	1. (literary) shade, shadow. 2. shelter.
cuisle	pulse/vein
teallach	hearth
uaireadóir	watch (timepiece)
taisme	accident
císte	cake
abhcóide	advocate.
curach	curragh (small boat)
léan	"Deep affliction; grief, anguish, woe.
A sense of sorrow and oppression.
Used in phrases indicating woe, grief, or holding a grudge.
aoir	satire
marcach	horseman
sú	"A. 1. juice. 2. sap	 vigor	 energy. 3. soup.
B. also [súigh-VN] (sucking) [Different declensions]"
achainí	Request	 entreaty	 petition.
loinnir	shine/glow
seift	device/stratagem
beoir	beer
lampa	lamp
otharlann	hospital
aigéan	ocean.
aistritheoir	translator.
machaire	plain/field
féasóg	beard
comhla	valve
sclábhaí	slave
blúire	bit	 fragment
cuairteoir	visitor
cláraitheoir	registrar
íobairt	sacrifice
seilf	shelf
aiféala	regret.
colm	dove/pigeon/scar
cóiste	coach
innealtóir	engineer
seanchaí	historian
saotharlann	laboratory
bior	point
feadóg	whistle
adamh	atom.
meitheal	work team
teangeolaíocht	linguistics
oráiste	orange
foighne	patience
bunaitheoir	founder
pláinéad	planet
iolra	1. Multiplicity	 plurality. 2. Gram: Plural. 3. (Used as attrib.a.) Gram:Phil: Plural.
gnúis	1. face.  2. Sour expression	 frown.
naomhóg	currach
aisteoireacht	acting
stábla	stable
seabhac	hawk
unsa	(m.) (1) ounce; (gs.) ~	 (pl.) ~í
iomaitheoir	competitor
deoraí	exile
gealt	madman
veain	1) van; (2) vehicle; (3) conveyance
ribe	hair
buicéad	bucket
árthach	vessel
rós	rose
moltóir	judge
lána	lane
aerárthach	aircraft.
aidiacht	adjective
faoileán	seagull
aoire	shepherd
lao	calf
íde	1. Ill usage; (wretched) state	 plight. ≈ tongue lashing. 
tréad	herd
ceardaí	craftsman
aguisín	Addition	 addendum.
spota	spot
nathair	snake
constaic	obstacle
bé	maiden
ailtire	architect
dréimire	ladder
coirm	feast
milseán	sweet
scuaine	queue
camán	hurling stick
drogall	Aversion	 reluctance	 or laziness.
bithiúnach	scoundrel
caor	berry
gála	gale
rabharta	flood
aga	period	 interval.
conraitheoir	contractor
cipín	stick
máistreás	mistress
cófra	cover/cupboard
aspal	apostle
biorán		 m. (gs. & npl. -áin	 gpl. ~). 1. Pin. ~ gruaige	 hata	 hairpin	 hat-pin. ~ brollaigh	 breast-pin; brooch. ~ dúnta	 safety pin. ~ suain	 (in folk tales) sleep charm. ~ a chur i rud	 to stick a pin in sth. Ní fiú ~ é	 it is worthless. Ar bhiorán buí bhuailfinn é	 for two pins I’d strike him. Ag imirt ~ sop	 casting lots (with straws). 2. ~ cniotála	 knitting-needle. ~ cróise	 crochet-hook. ~ eangaí	 net-maker’s needle. Tá sé ar bhiorán an chúil agam	 I have it nearly completed. Tá sé ar na bioráin agam	 I have it in hand. Tá an iomarca ar na bioráin agat	 you have too many irons in the fire. 3. Hand (of clock).
bailitheoir	collector
bádóir	boatman
barróg	1	 f. (gs. -óige	 npl. ~a	 gpl. ~).1. Hug. ~ a bhreith ar dhuine	 to hug s.o. 2. Wrestling grip. D’fháisc siad ~ ar a chéile	 they got to grips with each other. 3. Brogue	 impediment of speech.
aigéad	acid.
bréagán	Toy	 plaything. ~ linbh	 child’s plaything. Siopa ~	 toy-shop. 2. (Of woman) Doll.
airdeall	alertness.
ainmní	grammatical subject.
gliomach	lobster
carthanacht	charity/love
teachtaire	ambassador/messenger
féilire	calendar
tuiseal	(grammar) case
fleá	feast/banquet
spúnóg	spoon
bairille	barrel
aicíd	disease.
consan	consonant
aclaíocht	agility.
ceannaitheoir	buyer
mairnéalach	sailor
oidhre	heir
réiteoir	1. Arbitrator; conciliator	 peacemaker. 2. Sp: Referee. 3. (Device) Cleaner. ~ píopa	 pipe-cleaner.
gamhain	calf
leithinis	peninsula
gráin	1. Hatred	 abhorrence
ród	rod
oinniún	onion
cinnire	Person leading an animal. 2. Guide or attendant. 3. Specific roles: leader of a horse or plough team.
scamhóg	lung
nod	nod
coirpeach	criminal
leadóg	tennis
anró	hardship
grua	cheek
ciseán		 m. (gs. & npl. -áin	 gpl. ~).1. (Wicker) basket. ~ aráin	 éadaigh	 fuála	 bread-	 clothes-	 work-	 basket. ~ éisc	 fish-basket. 2. ~ éan	 (wicker) bird-trap.
rothaí	cyclist
searbhónta	Servant. (Var:searbhfhoghantaidhe m)
bard	bard
siolla	syllable
inscne	gender
aithrí	repentance.
seoid	jewel
ionga	(anat) nail; hoof; clove 
bogha	bow
tallann	talent
iománaí	hurler
cabhail	body/frame
sciorta	skirt
radacach	(1) radical
achadh	field.
casúr	Hammer
rolla	roll
canáil	canal
fuíoll	Remainder	 remains
guta	vowel
Coimisiún	commission
dílleachta	orphan
rámh	oar
rúndiamhair	mystery
nia	nephew
iomaire	ridge
dealg	thorn
díoltóir	seller
áibhéil	exaggeration
saighead	arrow
aitheasc	exhortation.
ráille	rail
iolar	eagle
ancaire	anchor
éisteoir	listener
gaiscíoch	1. Man of prowess (in arms); warrior	 hero. 2. Boaster.
fionnachtain	1. (Act of) finding; find	 discovery. 2. Invention.
seastán	(1) stand; (3) flower-	 music-	 book-	 stand; (4) grandstand
aineolas	ignorance.
pluid	blanket
muinchille	sleeve
aiséirí	resurrection.
féileacán	butterfly
muga	mug
sac	sack
riarthóir	administrator
matán	muscle
táilliúir	tailor
aicsean	action	 feat.
gall	foreigner
bábóg	doll
tua	axe; hatchet
tairngreacht	prophecy
briosca	biscuit
búistéir	butcher
tincéir	tinker
siopadóir	shopkeeper
folús	Emptiness; vacuum	 void.
banbh	piglet
suáilce	virtue
damhsóir	dancer
síleáil	1. Ceiling. 2. Wainscotting. 3. Partition (in house	 etc.).
síleáil	Severe trial; hardship	 toil.
tom	bush
irisleabhar	magazine
aitheach	renter/ churl.
rinceoir	dancer
ceannaí	merchant
mianra	mineral
deilbh	Frame	 figure	 or appearance; can also refer to the warp in weaving.
saothraí	laborer
mallaigh	(1) accursed person; (2) wicked person; (3) accursed of God; (4) vicious animal; (5) damnable trick; (6) abominable weather; (7) unholy desire; (8) bad lot
toit	smoke
cláirseach	harp
fealsamh	philosopher
aisghairm	repeal.
garáiste	garage
craos	gullet
cadás		 m. (gs. & npl. -áis	 gpl. ~). Cotton.
míthuiscint	misunderstanding
simléar	chimney
cuileog	fly
seanmóir	sermon
cailc	chalk
fothain	1. shelter. 2. discretion.
clúid	corner/cover
giúis		 f. (gs. ~e	 pl. ~eanna). Fir	 pine; deal. Crann ~e	 fir-tree	 pine-tree. ~ gheal	 silver fir. ~ bhán	 bhuí	 white	 yellow	 pine(wood). ~ Dhúghlais	 Douglas fir. ~ phortaigh	 bog-deal. S.a. MAIDE 1(a).
mangaire	pedlar
aighneacht	submission.
aireachtáil	perception.
créafóg	clay	 earth
buatais	boot
meadaracht	meter (poetry)
cairde	"1. respite. 2. (commerce) credit. 3. delay.
[Also the plural of ""cara""]"
moncaí	monkey
pléascán	explosion
brídeog	bride
náisiúntacht	nationality
taos	 1. Dough. Bíonn an ~ leis an iarta	 leis an oigheann	 i gcónaí aige	 he is forever trying to make ends meet. 2. Paste. ~ éisc	 fish-paste. ~ fiacla	 tooth-paste. 3 = TAOISLEANN.
crónán	(act of) humming; hum
aiteann	furze	 gorse.
earráid	error
carráiste	carriage
féirín	1. fairing; gift	 present. 2a. valuable acquisition.
céadfa	sense/perception
ainnise	misery.
dúshraith	foundation
deabhadh	"	 m. (gs. -aidh). Haste	 hurry. ~ a bheith ort	 to be in a hurry. ~ a dhéanamh (le rud)	 to make haste (with sth.). Prov:Moill ar tí	 in aghaidh	 le linn	 (an) Deabhaidh	 more hurry less speed. (Var:deabha f)

creig	crag/rock
leoithne	breeze
úrscéalaí	(m.) (1) novelist
teagascóir	instructor
cleasaíocht	trickery
Gallda	(1) mile, English statute mile; (2) Éirí gallda, to become Anglicized
aimhleas	harm, evil.
aithreachas	repentance.
dornálaí	boxer
cliabhrach	bodily frame; chest
iarla	earl
tarracóir	tractor
raithneach	(collective) Fern, bracken
dúch	ink
cuntasóir	accountant
doineann	.1. Stormy weather, storm. Tá doineann air, there is a storm brewing. Soineann nó doineann, fair or foul weather. Prov:Cothú na doininne soineann na hoíche, a calm night presages a storm. S.a. doineannsmadra1 4(a).2. (Of demeanour) Wintriness, cheerlessness.
eascaine	curse
neantóg	nettle
lámhleabhar	handbook
turcaí	turkey
ainnir	maiden.
cócaire	cook
lasta	cargo/load
áirse	arch.
ábaltacht	ability, strength
easna	rib
díle	flood
tuáille	towel
fiaclóir	dentist
cailís	chalice
cráin	crane (bird)
lóchrann	lantern
báisín	basin
sluasaid	shovel
amaidí	folly
caonach	"moss. 
~ liath: mildew
aibítir	alphabet.
sióg	fairy
caiséad	cassette
ceirt	rag
aimhréidh	entanglement.
peacach	sinner
anachain	calamity
ispín	sausage
agó	objection	 stipulation.
sceallóg	chip	 thin slice. 
céir	wax
láir	mare
tormán	noise
fallaing	robe
cuibheas	Fitness	 propriety; seemliness	 decency.
fiántas	1. Wildness	 fierceness	 savageness. 2. Wilderness. 
ceárta	1. forge. 2. Centre of activity	 of gossip. 3. collection of objects
díolaim	anthology
spiaire	spy
milseog	dessert
bairneach	limpet
ainniseoir	wretch.
crúiscín	jug
cealg	sting
galún	gallon
róba	robe
searrach	foal
aibhléis	electricity.
céachta	plough
áiféis	exaggeration.
broc	refuse/discards/badger
casacht	cough
anfa	storm
pianó	piano
ruainne	fragment/strand
áiléar	loft	 gallery of paintings etc.
réaltóg	star
coscán	brake
tionóisc	accident
míthreoir	misinformation
aimsiú	aim.
braillín	sheet
siúinéir	carpenter
adhradh	worship.
trup	Tramp; noise	 din.
dallóg	blindfold
flaith	prince/noble
scrúdaitheoir	examiner
eitic	ethics
dorchla	Corridor.
féidearthacht	possibility
carcair	prison
agairt	plea.
sealgaire	hunter
snoíodóireacht	(Act of) cutting	 carving	 sculpturing.
stua	arch
bóna	collar
deachtóir	dictator
diúracán	missile
ail	stone.
coisí	pedestrian
leabharlannaí	librarian
bladhm	flame
ceant	auction
láithreacht	presence
siosúr	scissors
rúitín	ankle
adhlacadh	burial	 funeral.
clódóir	printer
áititheoir	occupier.
meisceoir	drunkard
breab	bribe
péarla	pearl
adhastar	"Halter. 
Ar adhastar	 haltered	 led. 
Tá sé ar adhastar aici	 he is captivated by her. 
Bhéarfadh adhastar sneachta ann é	 he needs no persuasion to go there. 
Chuir sí a ceann in adhastar an anró	 she made an unfortunate marriage. 
Tá sé ag rith ar chos in adhastar	 he will trip himself up. 
Lig fad an adhastair leis	 give him plenty of rope."
pleidhce	fool
ciotóg	left hand
folcadán	bathtub
bláthach	buttermilk
aiféaltas	shame.
siléar	cellar
aeistéitic	aesthetics.
bearbóir	barber
tlú	tongs
áineas	sport	 play.
blaincéad	blanket
léana	meadow
tuisle	1. fall	 stumble	 trip. 2. slip	 blunder
tuisle	hinge
ailp	lump.
aibíocht	ripeness.
casán	brooch
aiseolas	feedback.
meancóg	mistake
cuilt	quilt
teicneoir	technician
aireachas	attention.
racán	noise
áiméar	chance.
tréidlia	Veterinary surgeon.
seamróg	shamrock
tarraiceán	drawer
reachtaire	governor
aicearra	shortcut.
óstóir	host
aisfhreagra	retort.
claibín	little lid (diminutive of "clab"). 3. bar of latch.
aibíd	monk’s habit	 shroud.
achasán	insult.
cnámharlach	1. skeleton. 2. extremely thin	 lanky	 person or animal.
veist	(1) vest	 waistcoat; (2) sleeved waistcoat (faoi mhuinchillí);
sreangán	string
áibhirseoir	devil.
téitheoir	heater
aiteas	fun	 pleasantness.
bladhaire	chatterbox
baincéir	banker
draein	drain
coimpléasc	1. Physical constitution; digestive system. 2. Girth	 circumference.
glóthach	"1. Jelly. 
Mála	 múnla	 glóthaí	 jelly-bag	 -mould. ~ bheathaithe	 gelatine meat-broth. ~ chóipeála	 hectograph jelly. ~ a dhéanamh de rud	 to jelly sth. Rinne sé carn glóthaí de	 he knocked him in a heap. 
2. Ch: Gel. 
3. Vet: Animal slime. 4. ~ fhroig	 frog-spawn."
leasmháthair	stepmother
neamhshuim	Lack of interest	 disregard	 indifference.
abacas	abacus.
abarthacht	wittiness.
abhac	dwarf.
ábhach	hole.
ábhacht	drollery.
ábhaillí	mischief.
abhantrach	river basin.
ábharachas	materialism.
ábharaí	materialist.
ábharthacht	relevancy.
abhcóideacht	advocacy.
abhlann	wafer.
abhlóir	buffoon.
abhóg	poor impulse.
abhras	yarn	 handiwork.
ablach	carrion	 carcass.
acadamhaí	academician.
acastóir	axel.
achomaireacht	brevity.
achomharcóir	appellant.
acraíocht	acreage.
adhaint	inflammation	 ignition in car
adhairt	bolster	 pillow.
adhall	heat (only in dogs).
adhaltranas	adultery.
adharcán	tentacle	 antenna.
adhartán	cushion	 compress.
adhlacóir	undertaker.
adhmadóir	woodworker
adhmadóireacht	woodwork; carpentry
adhmaint	magnet.
adhmholadh	eulogy.
adhnua	novelty.
adhraitheoir	worshiper.
aeracht	gaiety.
aeradróm	aerodrome.
aeraíl	ventilation.
aeraíocht	outdoor entertainment.
aerasól	aerosol.
aerbhrat	atmosphere.
aerfhórsa	air force.
aerlíne	airline.
aerloingseoireacht	aeronautics.
aermaíocht	(noun) the act of seeking pleasure; (noun) a term for pleasure-seekers.
aeróg	aerial.
aeróstach	airhostess.
aerphost	airmail.
agaill	earthworm.
agall	exclamation.
agnóisí	agnostic.
agra	lawsuit.
agús	addition.
aibhéis	abyss.
aibhinne	avenue.
aibreog	apricot.
aiceann	accent
Aidbhint	Advent.
aidiúnach	adjutant.
aidréanailín	adrenalin.
aife	ebb.
aifid	aphid.
aigneolaíocht	psychology.
ailbheolas	alveolus.
ailceimic	alchemy.
ailgéabar	algebra.
ailibí	alibi.
ailigéadar	alligator.
ailím	alum.
ailiúnas	alimony.
áilleagán	toy	 doll.
ailléirge	allergy.
áilteoir	trickster.
áilteoireacht	tricking.
aimiréal	admiral.
aimiréalacht	admiralty.
aimitis	amethyst.
aimléis	misery.
aimnéise	amnesia.
aimplitheoir	amplifier.
aimride	barrenness	 sterility.
aimsitheoir	marksman.
ainbhios	ignorance.
ainbhiosán	ignoramus.
ainchleachtadh	inexperience.
ainchreideamh	unbelief.
ainchreidmheach	infidel.
aincis	malignancy.
aindiachaí	atheist.
aindiachas	atheism.
aindleathacht	illegality
aindlí	lawlessness.
ainéistéiseach	anesthetic.
ainimh	blemish.
ainís	anise.
ainle	peevish person.
ainmheasarthacht	excess.
ainmhian	passion	 lust.
ainmníocht	nomenclature.
ainmnitheach	nominee.
ainriail	anarchy.
ainrialaí	anarchist.
ainriocht	wretchedness.
ainsprid	evil spirit.
aintiarna	despot.
aintiún	anthem.
aipindic	appendix.
aipindicíteas	appendicitis.
aireagal	oratory	 ward.
aireagán	invention.
áireamhán	calculator.
áirge	asset.
airgeadaí	financier.
airgeadóir	Cashier; teller (in bank)
áiria	aria.
airleacan	advance	 loan.
airnéis	chattels	 cattle.
airtléire	artillery.
airtríteas	arthritis.
aischothú	feedback.
aiseag	restoration.
aiseal	axle.
aiséiteach	ascetic.
áisiúlacht	convenience.
aiteacht	oddness.
aiteal	juniper.
áith	kiln.
aitheascal	oracle.
aithinne	spark.
aithis	slur.
aithríoch	penitent.
aithriseoireacht	mimicry.
amhastrach	barking
amp	amp
anchuid	excessive amount
aoine	fasting
aosán	evil fairy
Árainn	Aran Islands
ateangaire	interpreter
báicéir	baker
báidín	dinghy
báinseach	lawn
bairín	loaf
Ballstát	Member States
banchéile	wife
barriall		 f. (gs. -rréille	 pl. ~acha). Bootlace	 shoe-lace.
bealtaine	May
bruas	lip
cábóg	rustic
cág	jackdaw
ceimiceoir	chemist
céimseata	geometry
cinsire	censor
claicearnach	(Act of) clacking.
claidhreacht	"1. villainy	 roguery
2. cowardice"
claimhe	1. Manginess	 scurvy. 2. Plague	 pest. 
claimhteoir	swordsman
cláirseoir	harpist
cleasaí	trickster
cluife	game	 match
cneá	wound
daingne	strength	 security	 firmness	 solidity
daol	beetle
deabhaidh	Strife	 contention; fight.
deachú	tithe
dísle	dice
doichte	Tightness	 hardness	 rigidity	 rigour.
drochaimsir	bad weather
duáilce	1. Vice; fault	 defect. 2. Joylessness	 unhappiness
duga	dock
éalang		 f. (gs. -ainge	 npl. ~a	 gpl. ~). Flaw	 defect; weakness	 weak spot. ~ ar rud	 a flaw in sth. ~ nó easpa	 flaw or defect. Bean gan ~	 flawless woman. D’fhág an aicíd ~ air	 the disease debilitated him. ~ a fháil ar dhuine	 to find the weak spot in s.o.; to take s.o. at an unguarded moment	 at a disadvantage. ~ mheabhrach	 mental deficiency. (Var:éalann f)
fadáil	 f. (gs. -ála). (Act of) delaying	 lingering; dilatoriness.
faocha	limpet
feadhain		 f. (gs. & pl. -dhna). Band	 troop	 company. ~ fear	 band of men. ~ marcach	 troop of horsemen. Bheith ar an bh~	 to be one of the band. Níl aon fhear ar an bh~ inchurtha leis	 he is the best of the lot. Ceann feadhna	 leader	 commander; ringleader. Bhí sé ina cheann feadhna ar na hÓglaigh	 he was a leader of the Volunteers. An ceann feadhna ar na gasúir	 the ringleader of the boys. (Var:feadhan m & f)
feag	fig
feitheoir	supervisor
fillteán	folder
flóra	flora
fochupán	saucer
follasú		 m. (gs. -saithe).Jur: Discovery. ~ cáipéisí	 discovery of documents.
forainm	pronoun
foscadán	(of structure) shelter
Frainc	France
fútráil	act of fidgeting; bungling
Gael	Gael
Gaeltacht	Gaeltacht
gealtlann	asylum
geasróg	geas (spell)
goilliúnacht	Sensitiveness	 sensitivity; touchiness.
gráinne	grain
iargúil	1	 f. (gs. -úlach	 pl. -úlacha). Remote corner; backward	 out-of-the-way	 place; isolated	 solitary	 place. Dul ar an ~	 to retire to a remote place	 to seek solitude. Tá siad ina gcónaí ar an ~	 they live at the back of beyond.
iargúltacht	remoteness
inneoin	anvil
lámhainn	glove
lasán	match
leamstar	Thick slice	 hunk.
leiceann	cheek
leictreoir	electrician
liobar	1. Loose	 hanging	 thing; limp object.
lóistéir	lodger
longfort	encampment
luibheolaí	botanist
marfóir	murderer
matamaiticeoir	mathematician
measúnóir	assessor
meatachán	coward
meicneoir	mechanic
meitheamh	June
míghníomh	1. evil deed	 misdeed. 2. (jurisprudence) misfeasance
mírialtacht	irregularity
muilleoir	miller
neamhrialtacht	irregularity
oitir	spit of land
ollúnacht	professorship
pána	pane
pancóg	Pancake.
profa	prop
proinn	meal
ráca	rake
rámhaíocht	rowing
ranníocóir	contributor (to pension fund	 health care plan etc)
rannpháirtí	participant (noun)
réalteolaíocht	astronomy
rím	rhyme
ronnach	mackerel
sampláil	(noun) the act of sampling; 
scothóg		 f. (gs. -óige	 npl. ~a	 gpl. ~).1. (a) Flower	 blossom. (b) (Little) tuft. (c)Hort: Top. 2. Tassel. ~a seáil	 tasselled fringe of shawl.
seanaimsir	olden times
seancheann		 m. (gs. -chinn).1. Old one. 2. Old head. Tá ~ air	 (of child) he is precocious; he is too old-fashioned.
seanduine	old person
siúlóir	walker
snámhóir	swimmer
soineann	"1. Calmness	 clemency (of weather); fair weather.
2. Calmness	 serenity (of expression); pleasantness	 guilelessness."
spadaire		 m. (gs. ~	 pl. -rí). Sluggish	 lethargic	 person. (Var:spadaí2m)
spreasán	1. (Small) twig; stick (of firewood). 2. Worthless person.
sprionlóir	miser
strainc	grimace; contortion of the face
táibléad	tablet
taisceadán	treasure
taiscéalaíocht	(Act of) exploring	 reconnoitring; exploration	 reconnaissance.
teicneolaí	technologist
tionsclaí	industrialist
tosaitheoir	beginner
tréadaí	herder
treoirlíne	guideline
trilseán	1. Tress; braid	 plait. 2. (a) Plaited rushlight. (b) Link	 torch. 3. String	 long bunch.
uachtarlann	creamery
vaimpír	(1) Myth: Vampire; (2) Z: Vampire(-bat)
vótaíocht	(1) act of polling; (2) poll
asarlaí	1. Sorcerer. 2. Conjurer	 trickster. 3 = astralaí.
rabhchán	warning signal
scoilt	1. fissure	 crack. 2. parting. 3. breach of relations
múisc		 f. (gs. ~e). Vomit; nausea	 loathing. Chuirfeadh sé ~ ort	 it would sicken you. (Var:múis3f)
I mball éigin  "	"[not sure if this is as adv. or pronoun] 
somewhere."

i ndán (do)  "	fated, in store (for).
 ceann scríbe  	finishing-point; destination, goal. 
 go háirithe má  	especially if.
 i bhfad eile  	much longer
 I dteannta  	along with, in addition to. 
 san áireamh  	in consideration
 um an dtaca seo  	about this time, by now
’chuile bhliain  	every year
[X] agus corradh  	more than X
{bí} i gceist [le-X]  	"entails; intended, meant
involved; required
a chéile  	each other
a chlog  	o'clock
a chóir  	near
a chois  	beside
a dhíth (ar)  	needed (by)
a lán  	a lot	 much
a leithéid  	the like	 the likes
a thuilleadh  	"more
(in negative context) any more; any longer"
ach an oiread  	either
ach beag  	almost
ach cheana  	but anyhow
ach go háirithe  	anyway	 at any rate.
ach oiread  	either; no more than
aᴱ	all that (there is)
aeans dá laghad  	slim chance (typically used ironically/sarcastically)
ag an bpointe sin  	at that point.
ag brath (ar)  	depending (on)
ag seo cheana  	moreover
ag staid éigin  	at some point
agus cheana  	and furthermore
áirithe	certain; some
áit éigin  	somewhere
amach anseo  	from now on
amárach  	tomorrow
amhlaidh  	(adv) thus	 so
an bhliain seo chugainn  	next year
an chéad lá eile  	the next day
an chuid is mó	most
an lá cheana  	the other day
an méid a	that which
an mhí seo caite  	last month
an oiread céanna  	the same amount; as much
an rud a	that which
an rud is tábhachtaí  	the most important thing
an t-am ar fad  	all the time
an t-am sin  	at that time
an taca seo den bhliain  	at this time of year.  
an tseachtain seo caite  	last week
an tseachtain seo chugainn  	next week
an/na + [TimeNoun] + seo caite  	previous [TimeNoun]
an/na + [TimeNoun] + seo chugainn  	next [TimeNoun]
anocht  	tonight
anois  	now
anois is arís  	now and again
anú [TimeNoun]  	"the [PastTimeNoun] before last;
the [FutureTimeNoun] after next"
anuas ar  	down upon.
anuraidh  	last year ("uh-nur-ee" / "uh-nur-ig" / "uh-nur-uh")
aon duine	anyone	 anybody
aon nduine	anyone	 anybody
aon ní  	anything; nothing
aon rud	anything
ar [X] ar leith  	on a particular X
ar a bharr sin  	on top of that; in addition to that
ar a bheag  	at least
ar a laghad  	at least
ar a shon  	notwithstanding	 even though.  
ar a shon sin  	even so	 nevertheless. 
ar a shon sin is uile  	notwithstanding all that.
ar a son féin  	for herself
ar aghaidh  	ahead	 forward	 on
ar ais ar ball  	back in a while
ar amharc  	in sight
ar an ábhar seo  	because of this; for this reason
ar an ábhar sin  	because of that; for that reason
ar an aimsir seo  	nowadays
ar an bpointe  	right now	 immediately
ar an bpointe boise  	immediately
ar an drochuair  	unfortunately
ar an gcéad amharc  	at first sight
ar an gcúis sin  	for that reason
ar an iomlán  	on the whole; in general
ar aoi  	in regard to	 on account of
ar aon bhealach  	at any rate
ar aon ní eile  	of anything else
ar aon nos  	anyway
ar ball  	later; a while ago
ar bhealach  	in a way
ar bhealach
  "	in a way
ar bhealach éigin  	somehow
ar bhealach nua  	in a new, original, way
ar bith  	at all
ar bun  	afoot (going on)
ar chor ar bith  	at all
ar chúl  	behind; underneath
ar cois  	afoot (going on)
ar cúl  	in the back
ar deighilt  	in a separate place, separate.
ar deireadh  	finally
ar dtús  	first; firstly; at first
ar éigean  	4. (In adverbial phrase) Ar éigean, hardly, barely, with difficulty.
ar fad  	altogether
ar fáil  	available
ar fáil i rith ama  	 available all the time; available continuously
ar feadh  	"for (the duration of)
during, as far as, while, all the, for
ar feadh i bhfad  	for a long time
ar fud  	about	 across	 around
ar fud na háite  	all over the place
ar gach uile bhealach  	in every way.
ar gcúl  	behind
ar lár  	on the ground; down low
ar leanúint  	(to be) continued
ar leith  	 apart	 separate; several	 distinct; remarkable	 special.
ar lorg  	after	 looking for	 on the trail of
ar maidin  	in the morning
ar mo chuireadh  	at my invitation.
ar na mallaibh  	recently; lately
ar na saolta seo  	nowadays
ar ndóigh  	of course
ar nós  	in the manner (of)	 like.
ar nós cuma [le-X]  	as if X doesn't care; as if it's all the same to X
ar nós na gaoithe  	like the wind (very fast)
ar nós na tine  	like fire (very quickly)
ar scoil  	at school
ar shiúl  	away
ar siúl  	"afoot (going on)
afoot (on foot)
on"
ar tí  	about to; on the verge of (lit. on (the) track (of) ) + [IVNS]
ar togradh  	at will.
arae  	for	 because	 however
araon  	both
aréir  	last night
arís  	again
arís agus arís eile  	again and again
arís eile  	once again
arís is arís eile  	again and again
arᴸ	all that (there was)
arú amárach  	the day after tomorrow
as amharc  	out of sight
as an áireamh  	excluded; out of consideration
as measc  	from the midst of	 from among.
as taithí  	out of practice
b'éigean  	it was necessary
B'fhada ó  	it has been a long time since)
B’fhéidir go dtiocfaidh siad ar ball.  	Maybe they will come later.
b'in an méid    	(ba sin / ba in) that was all
beagán	few	 little
beagnach i gcónaí  	almost always
bean	
bliain is an taca seo  	this time last year.  
bliain ó shin  	a year ago
breis agus  	more than
cá bhfios dom?  	 (how do I know?)
ceachtar	"""ceachtar	 pron. 1. Either	 one or other of two; (with neg.) neither. 
ceachtar den bheirt	 den dá rud	 either of the two (persons)	 of the two things. ""
Déanfaidh ceachtar acu cúis	 either of them will do. (lit. will-do either at-them a-case)
Níor labhair ceachtar againn	 neither of us spoke. 
Ní chreidim ceachtar agaibh	 I don’t believe either of you. "
cheana  	previously	 before; already
cheana féin  	before a particular time (qv. "cheana")
choíche  	(adv) ever	 forever; (with neg.) never
chomh  	[+ adj] = "so"
chomh + [adj]  	as [ADJ] * see page on Comparative structures
chomh beag  	as little
chomh fada agus  	as long as
chomh luath is + [DRC]  	as soon as
chomh maith  	as well
chomh mór  	as much
chuige sin  	to that end (lit. for that)
chun cinn  	forward
chun deiridh  	"finally; to the end
at the back
behindhand"
chun tosaigh  	foreward; to the front
chúns + [DRC]  	while
cibé  	"anyway
1. whoever
2. [as indefinite pronoun]  whatever	 whichever
3.(a) (With ar bith	 cé) cibé ar bith é féin; cibé cé	 cibé ar bith cé	 hé féin	 whosoever he may be. cibé ar bith duine a bhí ann	 whatever person was there. cibé ar bith cén fáth a bhí aige leis	 whatever reason he had for it. cibé ar bith	 at any rate. cibé ar bith eile	 whatever else. 
(b) (With cá) cibé ar bith cá bhfuil sé	 wherever he is.
4. cibé acu (whether)"
cibé + [noun] + [DRC]	
cibé + ar bith	
cibé + ar bith + [DRC]	
cibé acú  	whether
cibé áit  	wherever; wherever (that may be)
cibé rud ar bith	
cóir máireach  		 right or wrong	 at all costs.
corradh le
corradh agus
corradh ar  "	more than.
corruair  	occasionally, Sometimes
cosúil leis seo  	like this
cuid	some, part
cuid mhaith  	a good part; quite a few
cuid mhaith de seo  	a good deal of this
cuir i gcás  	take for example
cur ar bun  	set up
d'áirithe  	allotted, certain, reserved
d'aon ghnó    	of set purpose; on purpose; deliberately
d'aon oghaim    	of set purpose; on purpose; deliberately
d'aon toisc    	of set purpose; on purpose; deliberately
d'aon turas    	of set purpose; on purpose; deliberately
d'fhios    	 to seek, to inquire about
d'fhormhór    	for the most part.
`  	therefore
dá dheasca sin  	therefore; in consequence of that.
dá fhad  	however long
dá sórt  	of its kind; like that
dála an scéil  	by the way; in the course of the story
dar [le-X]  	according to X
dár gcionn  	ahead
de bharr  	due to
de bharr (go)  	as a result of, because of.
de bharr [ar-X]  	more than X; over and above X
de bhrí  	because
de bhrí go  	whereas; because, by reason of the fact
de chogar  	in a whisper; in a mutter
de chuid  	belonging to
de dheasca  	in consequence of.
de gheit  	at a bound, suddenly; with a start
de ghnáth  	usually
de réir  	in accordance with, according to.
de réir cuma  	apparently.
de réir dealraimh  	apparently (≈ according to appearance)
de réir mar  	according to; as far as (lit. from wish as); as (indicating simultaneous action or development)
de roinnt  	of several
de thairbhe  	as a result of
de thapaigean  	suddenly, abruptly. 
dealraíonn sé go  	it appears that
den chéad scríob  	at the first attempt
do dhuine	"your man"; the person we're talking about; one
do leataobh  	to one side
do leith  	on the side of; in the direction of
don chuid is mó  	for the most part
duine	
duine ar bith	no one, nobody
duine éigin	someone, somebody
éinne	[M] anyone
fá choinne  	for; for the sake of
fadbh ar bith  	no problem
fadó  	long ago
fadó riamh  	ever so long ago.
fán ionnas sin  	 in that manner
faoi cheann  	at the end of, after
faoi choinne  	for; for that purpose
faoi deara  	notice
faoi dheireadh  	at last; finally
faoi láthair  	currently
faoi leith  	 apart, separate; several, distinct; remarkable, special.
faoi mar ≡  	as if
faoi réir  	free, available; ready
faoin am seo  	by this time
faoin rud sin  	regarding that (matter)
faoin taca seo  	about this time, by now
faoin taca seo amárach  	by this time tomorrow.  
faraor  	(but) unfortunately
fear	fear + de + na + [plural noun (men)] = one of the [nouns]
feasta  	"(adv) from now on, henceforth
 (with neg.) no more, not any more.
feasta choíche  	for all future time	 evermore; from now on
fós  	still	 yet
fosta  	as well; also.
gach	Everything
gach aᴱ	everything that
gach aon rud	every single thing
gach arᴸ	everything that
gach duine	everyone	 everybody
gach lá  	every day
gach ní  	everything (every + thing)
gach rud	everything
gach uile dhuine	every single person
gairid  	3. (As adv.)(a)Is gairid (go)	 it won’t be long (until). Is gairid ó bhí sé anseo	 it is not long since he was here. Ba ghairid ina dhiaidh sin (go)	 it was not long after that (until). Is gairid uait é	 you won’t have long to wait for it. Is gairid uainn an lá (nuair)	 the day is not far distant (when). (b)Is gairid a mhair sé	 he didn’t live long; it didn’t last long. Is gairid a rachadh sé ort; ba ghairid le dul ort é	 it wouldn’t last you long. Bheith rite gairid i rud	 to have run short of sth. Rugadh gairid air	 he was caught unawares. Nár bheire Dia gairid orainn	 may God not find us unprepared. (c)Bheith gairid d’áit	 to be close to a place. Tá sé gairid dá fhearg	 he is easily angered. gairid do mhíle	 nearly a mile. Is fada gairid a shiúil mé ar a lorg	 I travelled far and near in search of it. Chuaigh sé gairid go maith dó	 he went very near it; it was a very close thing for him. Go gairid	 in the near future.
gan choinne  	unexpectedly
gan iarracht  	without trying
gan trácht [ar-X]  	"to say nothing of	 apart from.
not to mention X;  "
gar do  	near to; close to
gearr  	"3. (As adv.)
Is gearr (ó)	 it is not long (since). 
Is gearr (go)	 it won’t be long (until). 
Is gearr ó bhí sé anseo	 he was here a short time ago. 
Ba ghearr leis go dtiocfadh an oíche	 he thought the night would come too soon. 
Is gearr a rachaidh sé orainn	 it won’t last us long. 
Is gearr le dul aige	 he hasn’t long to go. 
Is gearr eatarthu agat	 you change your mind quickly about things. 
Is gearr uainn anois é; is giorra uainn ná ar tháinig	 it won’t be long now. 
Is gearr eile a mhairfidh siad	 they won’t last much longer. "
glan  	4. (As adv.)(a)Millte	 scriosta	 glan	 completely spoiled	 destroyed. Sé troithe glan	 six feet exactly	 fully six feet. Punt glan	 one pound net. Diúltú glan do rud	 to refuse sth. absolutely. Ná maraigh glan é	 don’t kill him outright. Rinne mé dearmad glan de	 I clean forgot it. Tá sé glan as a mheabhair	 he has gone clean out of his mind. D’aon ghnó glan	 entirely on purpose. (b)Bheith glan ar	 de	 rud	 to be clear of sth. Fan glan air	 stay clear of it. D’fhan sé glan díobh	 orthu	 he kept away from them. (c)(Forpp.)Tá an tóir glan uainn	 the chase has cleared away from us. Bhí siad glan uaim abhaile	 they had cleared off home and left me. Tá mé glan acu	 they have fleeced me. (d)glandíreach	 clean and straight. Seasamh go glan díreach	 to stand up straight. Dul glan díreach (go)	 to go straight away (to). Go díreach glan; go cinnte glan	 exactly. (Críochnaithe) glan amach	 (finished) outright.
go bás  	till death
go bhfios dom  	(to my knowledge)
go brách  	forever	 for ever
go ceann  	"1. To the top of. 2. To the end of. 3. For the duration of.
until"
go ceisteach  	questioningly; interrogatively
go ciúin  	quietly
go cúramach  	carefully
go deireadh na scríbe  	all the way; to the very end	 till death
go deireanach  	late
go deo  	for ever	 always
go dian  	hard	 intensely
go díreach  	directly	 straight	 exactly
go dóchasach  	confidently; optimistically
go dtí seo  	until now; until this; so far
go dtí siúd  	up to then.
go fíorannamh  	hardly ever
go fiú  	even; at all
go fóill  	yet	 still
go garbh  	roughly
go garid  	soon
go gléasta  	in style
go haicearrach  	briefly
go haicearrach ina dhiaidh sin  	shortly afterwards.
go háirithe  	especially
go hannamh  	rarely
go hard  	high
go hiomlán  	completely
go hiondúil  	usually
go hiontach  	wonderfully
go lách  	politely	 nicely
go léir  	(of people) all
go leor  	enough	 plenty
go luath  	early	 soon
go maith  	well
go minic  	often
go moch  	early
go mór ná sin  	much more than that
go pointe  	(up) to a point
go pointe áirithe  	to a certain extent
go sciobtha  	quickly
go tapaidh  	quickly
go tobann  	suddenly
go trom  	heavily
i [ ] ionad  	in [ ]'s stead; in [  ]'s place
i bhfad barraíocht  	much too much
i bhfeidhm  	in operation; in effect; impact
i bhfolach  	hidden
i bponc  	in trouble
i dtaca [le-X]  	as regards X
i dtaca an mheán oíche  	close to midnight.  
i dtaca le + [IVNS]  	in connection with
i dtaca le holc  	all things considered.
i dtaca leis sin de  	as to that
i dtaithí  	accustomed to; used to
i dtólamh  	always	 all the time; continuously; still
i dtréimhse  	during
i dtreo is (go)  	so (that); in such a way (that)
i dtroiblóid  	in trouble
i gceann  	1. At the end of.
i gceannas  	in charge
i gceart  	"1. correctly	 properly
2. really	 truly	 actually	 entirely	
i gclár  	in the plane; on the surface
i gcomhair  	for; intended for; to get
i gcónaí  	always
i gcroílár  	in the heart of; in the center of
i gcuideachta  	in the company of
i lár  	at the center; in the middle
i láthair  	present
i leith (le)  	in regards (to)
i mbaol  	at risk; in jeopardy; vulnerable
i mbun  	"1. in the midst of, in the process of
- during
2. in charge of
i measc  	in the midst of	 among.
i ndáiríre  	really
I ndeireadh na mbeart  	finally
i ndeireadh na scríbe  	in the end	 finally.
i neart  	in many; in a lot of
i ngaiste  	in a trap	 trapped
i ngan  	without
i ngleic + [[le-X]]  	in struggle	 in combat; in approaching X
i réim  	in the period (of); during
i rith  	in all (of); ≈during the run of; during
i roinnt  	in some
in aghaidh  	against; `during
in aice [le-X]  	beside X
in aice láimhe  	nearby; near at hand
in aice le  	beside; next to
in ainm  	"- on behalf of
- nominally; supposedly"
in airde  	up
in áirithe  	allotted	 certain	 reserved
in aisce  	for nothing	 gratis
in áit  	instead of (lit. in place of)
in aithne  	into acquaintance
in am ar bith  	ever; never
in amharc súl  	in appearance
in ann  	able
in éineacht  	at the same time	 at once; together	 altogether. 
in inmhe  	"Dul in inmhe	 to prosper.
Teacht in inmhe	 to grow strong	 mature."
in uachtar  	in dominance; is dominant
inné  	yesterday
iomlán	full	 whole	 complete
ionas (go)  	so (that); in order (that)
iontach  	(Intensifying	 with adjective)
iontas  	surprise	 wonder
is beag [NEG]  	almost
Is dócha go mbeidh siad anseo.  	‘They’ll probably be here.’
is fíorannamh  	very little
is gearr go  	soon
laistigh de  	in less time than; ≈ within
láithreach  	immediately
láithreach bonn  	immediately
lasmuigh  	"1. On the outside	 without	 outdoors.
2. apart"
lasmuigh de  	2. Apart from
le cleachtadh  	with practice
le déanaí  	recently; lately
le gairid  	shortly; recently
le go  	? so that ...
le haghaidh  	"against	 for	 towards
for	 in provision for"
le háireamh  	extra	 over
le hamharc (an) lae  	at dawn
le linn  	"1. in the course of; during
2. because of"
le tamall  	for a while
le teacht i dtaithí  	to get used to
lena n-áiríodh  	including
mar an gcéanna  	likewise
mar gheall ar  	because of
mar i ndáiríre  	in fact; because really
mar is ceart  	as is right; properly
mar is cóir  	properly
mar is mion agus is minic  	as is often the case with small matters
mar nós  	as usual
mar sin féin  	however
méid ar leith  	a certain amount
mórán	(neg. and interr.) many	 much
mórthimpeall  	(As prep. & adv.) Surrounding	 all round.
murab é go	if it were not the case that; if not for the fact that
ná a mhalairt  	nor vice versa
neach	"(pronoun)
neach ar bith	 any one	 no one. 
Gach aon neach	 everyone.
aon neach = anyone"
ní ba mhó  	thenceforth
ní hamáin le  	not only with; not only to
ní mar  	not as
ní mar (sin) a/is + [C]  	not like that	 that ...
ní móide go  	probably not	 hardly
ní mór [[do-X]]  	it is necessary (for X)
níos lú  	less
níos mó  	more
nó (go/nach)  	until (... not)
nóiméad ó shin  	a moment ago
nuair + [DRC]  	when
ó am go ham  	from time to time
ó shin  	ago
ó thaobh  	"1. from X side
2. in terms of"
oíche Shamhna  	Halloween night
óir  	[conj] because; for
os ard  	aloud
os coinne  	in front of	 opposite. 
os íseal  	softly	 quietly
pé	
pé + [noun] + [DRC]	
pé + ar bith	
pé áit a bhfuil sí	[wherever] wherever she is
pé ar bith duine	[as whatever	 whichever] whatever person
pé ar bith rud	[as whatever	 whichever] whatever thing
pé ceann is fearr leat	whichever one you prefer
pé duine	
pé hé féin	
pé rud	
pé rud a dúirt sé	whatever he said
pé scéal é	anyhow (lit. whatever story it)
riamh  	ever
roimh ré  	in advance; ahead of time; beforehand
roinnt  	"(adv) somewhat
(proun) some	 several"
roinnt daoine	some people
roinnt mhaith	quite a few
ruainne  	little bit
rud	a thing
rud a	"(a thing) which
see Echoic Relative clauses in Complementation"
rud ar bith	nothing
rud éigin	something
sa bhaile  	at home
sa chaoi sin  	that way; in that way
sa chathair  	in the city
sa chéad dul síos  	in the first place
sa chistin  	in the kitchen
sa lá atá inniu ann  	nowadays
sa mbaille  	at home
sa seomra  	in the room
san am i láthair  	at the present time
san oifig  	in the office
scaití  	sometimes
seo	here / this
sin	there / that
sin ar fad ráite  	that's all said; ≈ that being said
sin é an rud  	"that is the point" (lit. the thing)
siúd	
siúd is go  	even though.
sol má  	before
sula i bhfad  	before long
tá dealramh air go  	it appears that. (lit: is an appearance on-it that)
tamall  	a while
tamall ó shin  	a while ago
taobh thiar  	behind
tar éis  	after
thairis sin  	moreover	 besides that	 apart from that
thall  	over	 beyond
thall ansin  	over there
thall úd  	over yonder
thar a bheith  	extremely
thar barr ar fad  	excellent; over-the-top good
thar moladh beirte  	literally translates to "beyond the praise of two	 meaning something so bad that even two people wouldn't praise it.
thar n-ais  	ar ais (back; again)
tráthnóna  	in the evening
trí chéile  	together
trína chéile  	mixed up; confused
tús a chur  	to begin
uair sa tseachtain  	once a week
uaireanta  	sometimes
úd	yon, yonder; that
uilig	all, everyone
um an dtaca sin  	about that time
D'aon scríob amháin  	at one go
i léig  	in decline
faoi seach  	(i) in turn; occasionally; respectively; (ii) in confusion
agus araile	et cetera.
mas é go  	whether
go dearfa  	certainly, indeed
go cinnte dearfa  	most assuredly
go deimhin is go dearfa  	really and truly
go deimhin féin  	in very truth
i láthair na huaire  	at the moment
cuid mhór X  	a lot of X
ar chúis éigin  	(adverbial phrase) for some reason
de shaghas éigin  	of some kind
de shíor  	for ever, constantly. 
ag an staid seo  	at this stage
as seo amach  	from now on
as siocair go  	because. 
ar siocair go  	because. 
mar dhea  	supposedly; indeed! as if; forsooth
ar lasadh  	alight
le cloisteáil  	audible; to be heard
i ndeireadh na dála  	when all is said and done.
anonn  	"1. Over, to the other side.
2. advanced, late
faoi mar  	as if; as
i gcoinne  	against
i gcaoi is go  	in such a way that
i bhfad  	distant	 far
i réimsí eile  	in other areas
thar ceann  	excellent
ar an toirt  	on the spot	 immediately
sa deireadh thiar thall  	at long last; in the long run; eventually
ó am go chéile  	from time to time
ar a bhonn  	~ from the base	 on the base
féidir  	
freisin  	(adv) also
diaidh  	(substantive)
diaidh ar ndiaidh  	gradually
diaidh i ndiaidh  	gradually
i ndiaidh ar diaidh  	gradually
as diaidh  	after
 Ach oiread leis sin  	for that matter
áfach  	however
riamh go fóill  	never yet. 
(Var:fá dear	 fé ndear(a)	 fé ndeár) variants of "deara"   	
beagnach  	(adv) almost
gan on  	faultless	 unblemished
i dteannta  	(adv phrase) along with	 in addition to.
i ndéanaí an lae  	late in the day
ar a dhéanaí  	at the latest
go dtí le déanaí  	until lately
ionas go  	so that
ionas nach  	so that ... not
i ngach treo  	in all directions	 everywhere
i ngach aon treo baill  	in all directions	 everywhere
cuir	put
déan	do
tabhair	give; notice; take; bring
abair	say
tar	come
bain	 extract	 cut	 release	 or win. (Extract or dig out. 2. Reap or pick. 3. Open or release. 4. Shed or bring about. 5. Strike or make a sound. 6. Agitate or annoy. 7. Lift or set afloat. 8. Win or gain. 9. Become due.)
téigh	go
téigh	heat	 warm
faigh	get
caith	"A. 1. wear. 2. consume. 3. spend. 
B. 1. throw	 cast. 
C. (Auxiliary verb used mainly in future & conditional to denote obligation	 necessity)"
feic	see
éirigh	"1. rise. 
2. become."
lean	follow
tuig	understand
tarlaigh	[vt] [vi] 1. Haul. Ualach a tharlú	 to haul a load. Bád a tharlú	 to haul	 warp	 a boat. 2. (Of harvest) Bring in	 garner. An fómhar a tharlú	 to gather in the harvest.
tarlaigh	happen	 occur
fág	leave
tóg	take	 build (5b. rouse	 excite)
glac	take	 accept
ceap	"think
3. Appoint	 assign."
féach	[M] look
clois	hear
tosaigh	begin	 start
buail	strike	 hit
beir	carry	 catch
mol	praise
imigh	go
léirigh	2	 v.t. Beat	 beat down	 subdue. Líon a léiriú	 to pound flax. ~ sé go binn iad	 he beat them soundly. Tá an duine bocht léirithe go maith	 the poor fellow is badly done up	 in bad shape.
léirigh	"v.t. & i. 1. Make clear	 explain	 illustrate. Caint	 smaointe	 an rud atá doiléir	 a léiriú	 to elucidate speech	 thoughts	 what is obscure. Rud a léiriú le sampla	 to illustrate sth. by example. ~ amach é	 set it forth clearly. Aerluas	 airde	 léirithe	 indicated airspeed	 elevation. 
2. Set in order	 arrange. Do chuid oibre	 do ghnóthaí	 a léiriú	 to order one’s work	 affairs	 properly. ~ ar an tseilf iad	 arrange them on the shelf. ~ ort	 get yourself ready. 
3. Clear up	 finish off. An béile a léiriú	 to finish off the meal. 
4. Th:Cin: Produce. Dráma a léiriú	 to produce a play.
[LIO] exhibit; show
№ 5. represent (like a metaphor)"
fan	stay	 wait	 remain
síl	1. think	 consider. 2. expect	 intend
geall	1. pledge	 promise. 2. allot	 ordain.
deir	(verb) abair 1.
lig	let
creid	believe
gabh	"A. take
B. 1. go. 2. come."
mair	live
labhair	speak
meas	estimate
tit	fall
úsáid	use
maith	forgive
teastaigh	Be wanted	 needed (ó	 by).
scríobh	write
iarr	1. ask	 request. 2. attempt	 try.
leag	1. knock down. 2. lower. 3. lay	 set.
suigh	sit
inis	tell
bunaigh	found	 establish; (with "ar") base on
cinn	A. 1. (Lit) step. B. fix	 determine	 decree. decide
tarraing	Pull	 draw. 1. (a) Pull	 tug	 draw towards oneself. (b) Draw along	 drag. (c) Haul. (d) Fish: draw nets. (e) Pull into position. (f) Drag out of position. (g) Row: pull an oar. (h) Pull to stop. 2. (a) Pick	 pluck. (b) Extract. 3. (a) Cause to flow. (b) Draw from container. (c) Draw matter from. (d) Spring. (e) Extract essence. 4. Take at random. 5. (a) Obtain from source. (b) Bank: draw a bill or cheque. 6. (a) Draw in	 breathe. (b) Cause draught. (c) Allow to come through. (d) Suck. 7. Attract. 8. Trace	 delineate. 9. Bring about	 cause	 induce. 10. Ship drawing water. 11. (a) Proceed. (b) Move towards.
caill	lose
cor	[vt] [vi] turn.
cas	twist	 turn
luaigh	mention; quote
foilsigh	1. reveal	 disclose	 make manifest. 2. publish
seol	≈ navigate. 1. sail. 2. send	 dispatch; direct	 guide. 3. address
seas	stand
aithin	recognize
léigh	read
braith	1. perceive	 feel. 2. spy out	 note. 3. betray. 
líon	fill
fill	return
scaoil	release	 loosen
maraigh	kill
fear	2	 v.t. (pp. ~tha). 1. Grant	 provide. Fáilte a fhearadh roimh dhuine	 to accord a welcome to s.o. 2. Pour out	 give forth	 shed. Ag ~adh na ndeor	 shedding tears. D’fhear sé a fhearg orthu	 he vented his anger on them. D’fhear sé sneachta trom	 there was a heavy fall of snow. 3. Wage. Cogadh a fhearadh	 to wage war. ~adh cath eatarthu	 a battle was fought between them. 4. Perform	 execute; hold	 observe. Lit:~adh aonach leo	 a fair was held by them. D’fhear sé cleas	 he performed a feat. ~adh a chluiche caointe	 his funeral rites were held. 5. Affect; benefit. Bhí an deoch ag ~adh air	 the drink was taking effect on him. Tá sé ag ~adh air le fada	 it has been affecting him for a long time. Is gairid go mbeidh a chlann ag ~adh air	 his children will soon be a help to him. 6. Excrete.
ciallaigh	1. mean	 signify. 2. explain	 interpret.
áirigh	count
nigh	wash
bris	break
measc	1. mix; mix up. 2. stir.
tagair	1. refer	 allude. 2. mention.
oscail	open
breathnaigh	"1. observe	 examine. 
[C] 2. look at	 watch. 
3. look	 appear."
cuimhnigh	remember
coinnigh	keep
fiafraigh	ask
roinn	1. Divide. (a) Separate into parts. (b) share	 apportion.
spreag	urge	 incite
cum	compose/create
rith	run
socraigh	settle; arrange (socraigh ar mhias = arrange the dish(es) ?)
cónaigh	dwell
cruthaigh	1. create. 2. form. 3. prove.
taitin	shine
mór	1. magnify; exalt	 extol. 2. increase
mínigh	1. smooth	 polish; 2. Make gentle	 assuage	 quiet. 3. Explain	 expound	 interpret. 
íoc	heal	 cure
íoc	pay
cuireadh	(1) to invite	 issue an invitation to; (2) to summon someone to a meeting; (3) to challenge to a fight
dóigh	burn
fógair	announce
luigh	lie down
pós	marry
freagair	answer
buaigh	[vt][vi] 1. win	 gain
stop	1. stop. 3. stay	 lodge. 4. stop up (a hole)
oibrigh	work
imir	play
mothaigh	1. feel. 2. sense	 perceive. 3. hear.
fás	grow
athraigh	1. change	 alter. 2. move.
ceannaigh	buy
roghnaigh	choose	 select
bronn	award. grant	 bestow
sroich	reach	 attain
tuill	earn (money)	 deserve
can	chant	 sing
bog	move; soften
dún	close
éist	listen
bailigh	gather	 collect
aontaigh	1. unite. 2. assent	 agree. 3. fit. 4. cohabit 
ith	eat
ardaigh	raise	 elevate	 ascend	 carry
críochnaigh	[vt] [vi] finish; complete	 accomplish
gearr	cut
cuidigh	1. (lit) share. 2. help.
díol	sell
smaoinigh	think
siúil	walk
airigh	hear
diúltaigh	[vt] [vi] 1. deny	 refuse.
dein	(1) to do	 to make; (2) to perform	 to execute
nocht	1. (a) bare	 strip. 2. become visible	 appear.
sín	stretch  4. Stretch forth; hold out	 proffer. "pass to me"
samhlaigh	1. imagine
taispeáin	show
ceadaigh	1. permit	 allow. 2. ask permission	 consult.
ól	drink
iniúch	scrutinize	 audit
pléigh	"plead	 discuss
deal; have to do with; associate with"
géill	(with do) yield	 submit; surrender
múin	teach	 instruct
soláthair	gather
dírigh	1. straighten
amharc	[U] look
sonraigh	1. specify. 2. take notice of.
leath	1. spread. 2. open wide. 3. become confused	 indistinct. 4. perish. 5. (lit) halve	 divide.
las	light
foghlaim	learn
dearc	look	 behold; regard	 consider
aimsigh	1. aim. 2. hit. 3. find	 locate. 4. attack. 5. tempt.
ainmnigh	1. name. 2. nominate. 3. specify.
alt	(1) to articulate	 to join
eagraigh	1. arrange	 organize. 2. set	 ornament.
togh	1. choose	 select. 2. elect.
scrios	destroy
scaip	scatter; distribute; spread; dissipate
admhaigh	1. acknowledge. 2. confess.
comhlíon	fulfil. 1. perform	 observe. 2. complete. 3. satisfy.
tosnaigh	(1) to begin	 to start; (2) to commence.
glaoigh	call. 1. cry out. 2. summon.
ceangail	tie	 bind
aistrigh	"change
aistrigh1	 v.t. & i. 1. Move; transfer	 translate. Troscán a aistriú	 to shift furniture. Duine a aistriú (ó	 go)	 to transfer s.o. (from	 to). Airgead	 maoin	 a aistriú	 to transfer money	 property. Pobal a aistriú	 to transplant people	 a population. Easpag a aistriú	 to translate a bishop. Cónaí a aistriú	 to move house. Tá an ghaoth ag aistriú	 the wind is changing. Ná h~ an scéal sin	 don’t carry that story (to other ears). 2. (Of figures	 music	 etc.) Transpose. 3. Journey	 travel. ~ liom sa ród	 take the road along with me. 4. Ling: Translate. Leabhar a aistriú go Gaeilge	 to translate a book into Irish.
- transfer universities"
cleacht	1. perform habitually. 2. practice. 3. (theater) rehearse.
cabhair	Emboss	 chase.
iompaigh	"1. turn. 2. Invert	 reverse. 3. Avert. 4. return. 5. change.
see tiontaigh"
cosain	protect
oir	suit	 fit	 adapt; (as of clothes)
leasaigh	1. amend	 reform. 2. (a) cure	 preserve. (b) dress	 curry. (c) flavor  3. manure	 fertilize.
foráil	(Lit) command	 enjoin
croith	1. shake. 2. scatter	 sprinkle.
eisigh	issue
croch	hang
beartaigh	1. (Lit) cast. 2. poise	 brandish. 3. plan	 contrive.
réitigh	1. level;  2. Unravel	 disentangle	 free. 4. Solve	 resolve	 elucidate
ordaigh	order
éiligh	1. claim	 demand. 2. complain.
bac	1. balk	 hinder. 3. heed.
cothaigh	1. feed	 nourish. 2. stir up	 promote. 3. maintain; hold fast.
méadaigh	increase
dúisigh	awake
meall	1. beguile	 charm; entice. 2. delude	 deceive; disappoint.
stad	stop
coimeád	keep. 1. observe. 2. guard. 3. retain.
freastail	attend (go to); attend (wait on); apply oneself to
dearbhaigh	1. Declaration. 2. Affirmation or attestation. 3. Confirmation or assurance.
scar	spread
caoin	1. keen	 lament. 2. cry	 weep.
cáin	censure
crom	bend	 stoop
teip	fail
sáraigh	1. violate. 2. thwart. 3. (of "constaicí"	 obstacles; "bás"	 death) surmount
cinntigh	make certain
gluais	move
glan	clean
brúigh	1. press. 2. push	 shove. 3. crush.
riar	administer
séid	blow
éalaigh	[vi] 1. escape. 2. evade. 3. abscond. 4. elope.
cluin	hear
dear	design
gnóthaigh	1. work	 labor. 2. win	 gain. 
pléasc	1. explode. 2. bang.
feidhmigh	[vt] [vi] 1. Function; act	 officiate. 2. Execute	 enforce	 apply.
iompair	carry	 convey	 transport
craol	1. announce	 proclaim. 2. broadcast.
tacaigh	support; back	 hold up
folaigh	1. hide	 cover. 2. include.
poibligh	publicize
fáisc	squeeze
báigh	drown
tairg	offer; proffer; ≈ sell
eascair	1. spring	 shoot	 sprout. 2. (of day) break.
sínigh	1. sign (a letter	 a contract). 2. (literature) signify	 indicate
tabhaigh	earn	 deserve
teith	flee
sil	loosen
scairt	1. shout	 call. 2. burst out.
séan	A. mark with sign. B. deny.
fulaing	suffer
codail	sleep
scrúdaigh	examine
éag	die	 decay
fáiltigh	1. (lit) rejoice. 2. welcome.
stán	stare
seachain	[vt] [vi] (1. avoid	 evade	 shun. 2. take care; guard	 shield. 3. yield)
tréig	abandon
clúdaigh	cover
ionsaigh	attack
maígh	state	 declare
saothraigh	1. Labour	 toil. 2. (a) Work	 till	 cultivate. (b) Bring into cultivation	 reclaim. (c) Cultivate	 develop. 3. Earn. 4. To work one’s way. 5. To work in	 to manoeuvre.
comhair	count	 calculate
druid	1. close	  shut.
láigh	"[vi] to dawn / become day
<small>dawn broke over the hills = bhí sé ag láchan ar na cnoic</small>
<aside>another way using ‘to sprout’: tá an lá ag eascairt = the day is breaking</aside>"
tuairiscigh	[vt] (Journalism) report
meabhraigh	1. commit to memory. 2. recall	 remind.
dealraigh	1. shine. 2. appear. 3. judge (by appearance).
laghdaigh	lessen	 reduce
tiontaigh	"turn. (as in	 ""turn left"") 1. revolve; change direction. 2. invert	 reverse. 3. return.
see iompaigh"
dáil	portion out
gortaigh	(verb transitive) to hurt or injure someone or something	 either physically or mentally; (verb transitive) to cause harm or damage.
forbair	[vt] [vi] 1. develop. 2. (math) expand
ríomh	compute; count
lorg	seek; track
breac	1. Speckle	 dapple. 2. Mark with letters	 figures; write. 3. Lighten	 change	 in colour. 4. Carve	 engrave
tionóil	collect
ceistigh	[vt] [vi] question	 interrogate
gníomhaigh	"1. to act
2. activate"
preab	1. start	 spring	 jump. 2. (of ball) bounce. 3. throb.
réigh	solve/clear
goill	(with ar) grieve	 pain; afflict
cruinnigh	gather	 assemble
pioc	1. pick. 2. preen	 spruce. 3. pluck (bird).
ullmhaigh	make	 prepare (eg. a sandwich)
gin	give birth	 germinate. generate.
feil	suit	 oblige
beannaigh	bless
gráigh	love
múscail	awake
doirt	pour	 spill; shed (blood)
sáigh	thrust
troid	fight
déileáil	deal (with)
cabhraigh	help
seinn	play (music)
póg	kiss
gair	call
ceil	conceal
teann	tighten
múch	"smother; extinguish	 put out
turn off (""an fhuaim""	 the noise (of an alarm) )"
guigh	pray
tost	become silent
nasc	tie	 bind; link
díbir	banish
saolaigh	1. [AUT] be born. 2.deliver. 3. give length of life.
rialaigh	rule. 1. govern	 control. 3. regulate
pill	(1) to shell	 to peel; (2) to cover with a shell
baist	1. baptize. 2. name. 3. add water to.
goid	steal
claon	[vt] [vi] 1. incline; yield 2. pervert
geal	1. whiten	 brighten. 2. (fig) make	 become	 glad	 happy.
cuimil	[vt] [vi] 1. Rub; stroke	 fondle; wipe.
réab	tear	 rend	 rip up
trácht	travel; discuss
deonaigh	grant	 consent; vouchsafe
blais	taste
tráigh	ebb
sásaigh	please (eg. others) ; satisfy; feed
bréan	[vt] [vi] 1. Pollute. 2. Putrefy
slog	1. swallow. 2. engulf. 3. sink	 recede. 4. absorb quickly. 5. accept eagerly.
sleamhnaigh	1. slide	 slip. 2. go unnoticed. 3. smooth.
fóir	help
scuab	sweep
mill	spoil; mar	 ruin
corraigh	stir
staon	stop	 desist
cuimsigh	"[vt] 1. Comprehend; connote; comprise	 include. 
2. Ph: Concentrate. 
3. (a) Arrange	 control	 limit. 
(b)Mth: Bound."
tiomáin	[vt] [vi] drive
sciob	snatch
gob	1. Peck (ar	 at). 2. (a) Project. 3. (Of plants) Spring	 shoot	 sprout.
borr	swell	 grow
triail	try
ruaig	1. chase	 put to flight. 2. (with ar) attack. 3. punch out.
leigheas	heal
scoilt	split
gáir	laugh	 shout
maolaigh	1. make	 become	 bare or bald. 2. blunt. 3. lower	 flatten.
tuirling	descend
lúb	[vt] [vi] bend	 loop
fostaigh	1. catch	 hold fast	 grip. 2. engage	 retain in service; hire	 employ.
iasc	fish
béic	cry out
scoir	unyoke
deimhnigh	certify; affirm
gléas	adjust	 dress
luasc	swing	 oscillate
tacht	choke; strangle
sceith	1. vomit. 2. spawn. 3. overflow. 4. disseminate.
ísligh	lower	 depress
treoraigh	1. guide	 lead	 direct.
cíor	1. comb. 2. examine minutely	 search.
leathnaigh	widen	 extend
clis	stop working
vótáil	[vt] [vi] vote
áitigh	occupy	 argue;settle down to
bagair	1. brandish. 2. beckon. 3. threaten.
scanraigh	1. rout. 2. frighten. 3. take fright.
simpligh	simplify
sábháil	save
bolg	bolg2	 v.t. & i. (vn. ~adh m	 gs. & pp. ~tha). 1. Bulge. Rud a bholgadh	 to bulge	 swell out	 sth. Seolta a bholgadh	 to fill	 swell	 sails. Muinchillí a bholgadh	 to puff out sleeves. Balla	 carraig	 ag ~adh (amach)	 wall	 rock	 bulging (outwards). Farraige bholgtha	 swollen	 heaving	 sea. 2. Blister. Péint ag ~adh	 paint blistering.
brostaigh	1. hasten	 urge. 2. hurry.
sann	[vt] (Jur) assign
oil	nurture
santaigh	covet
sealbhaigh	"1. possess; gain. 2. acquire
agus iad ag sealbhú dhá theanga – ""while acquiring two languages"""
toiligh	will	 consent	 agree
coisc	prevent
taithigh	1. frequent; consort (le	 with). 2. become accustomed to.
díobh	harm
táirg	produce	 manufacture
cnag	knock
greamaigh	1. attach	 fix	 fasten. 2. become stuck. 3. grasp	 seize.
léim	jump
at	swell	 bloat
múnlaigh	1. mould. 2. form	 shape.
tionscain	1. begin	 originate. 2. contrive	 attempt
taifead	(to) record
cláraigh	1. flatten	 beat. 2. tabulate	 list	 register
cuntais	count
cloígh	[vt] to subdue
cloígh	To stick to work or a task. 2. To cling to people or groups. 3. To abide by a promise.
síolraigh	[vt] [vi] 1. breed	 propagate.
togair	"desire	 choose	 attempt
Ar togradh	 at will. (Var:togra m)"
scread	scream
dearg	1. redden. 2. blush	 flush. 3. blaze	 shine	 glow
snámh	swim
dearmad	forget; overlook
taistil	travel
gread	"1. strike	 hit. 2. sting	 scorch.
≈ crash (of waves)"
treabh	plough
triomaigh	dry
leáigh	melt
comhairligh	1. advise	 counsel. 2. decide	 resolve.
daingnigh	Fortify; strengthen	 secure; make fast	 fix; confirm	 consolidate. 
scag	1. strain	 filter. 2. drain off. 3. refine.
sciorr	1. slip	 slide	 slither.
teilg	cast	 throw
básaigh	1. put to death. 2. die.
trasnaigh	1. cross	 traverse. 2. contradict.
dreap	climb
ciontaigh	1. blame	 accuse. 2. convict. 3. transgress.
neartaigh	strengthen
impigh	entreat	 supplicate
fair	watch. 2. Look out for	 await	 expect. 3. Impend over	 threaten. 4. Wake (of the dead):
cuardaigh	search
liostaigh	list	 enumerate
aithris	recite; narrate
fliuch	(adjective) wet; (verb transitive & intransitive) to wet	 as in wetting clay	 cloth	 or one's head.
scríob	scrape	 scratch
tapaigh	quicken; grasp quickly; hurry
lonnaigh	[vi] Become angry. ~ faoi	 uime	 he flew into a passion.
lonnaigh	settle
cúlaigh	move back; reverse	 retreat
fionn	fionn4	 v.t. & i. 1. Make white	 whiten. 2. Clear	 brighten. Tá an lá ag ~adh thoir	 the day is breaking	 brightening	 in the east. 3. Scorch	 singe; set alight.
fionn	fionn5	 v.t. 1. Ascertain	 discover. Rud a fhionnadh ar	 ó	 dhuine	 to find out sth. about	 from	 s.o. Ná ~adh d’athair ort é	 you had better not let your father find out about it. D’fhionnamar a n-ainmneacha uaidh	 we got to know their names from him. ~aim an bhréag air	 I can see that he is lying. Go bhfionna cách do dhúthracht	 so that all may see whether you are in earnest. Jur:Ciste ~ta	 treasure trove. 2. Contrive	 invent.
achtaigh	enact	 decree
rianaigh	1. mark out	 trace. 
loisc	burn
taobhaigh	(often with le) 1. approach. 2. side with. 3. resort to.
súigh	absorb	 suck
goin	(a) Literary. wound. (b) Wound; stab	 sting	 hurt.
dúnmharaigh	murder
neamhnigh	Nullify	 annul	 quash	 annihilate.
pleanáil	plan	 scheme
eitil	1. fly; flutter. 2. (Of flame) Flicker.
cúisigh	accuse
triall	travel
cóirigh	1. arrange	 dress. 2. mend	 repair.
comhfhreagair		 v.t. (pres. -graíonn	 vn. ~t).Correspond. Ag ~t a chéile	 dá chéile	 corresponding	 harmonizing	 with each other.
loit	hurt	 damage
tum	dip	 immerse
sméid	beckon/nod
feall	betray
creim	corrode/gnaw
crap	shrink
teagmhaigh	happen
tuairimigh	[vt] [vi] (opine	 conjecture)
feabhsaigh	improve
stróic	1. tear	 rend. 2. perform with great speed.
treisigh	strengthen
údaraigh	1. authorize. 2. originate.
teagasc	teach
maisigh	adorn	 decorate
aor	satirize
tuar	augur	 predict
tuar	bleach
caoch	[vt] [vi] 1. Blind; daze; dazzle.
caoch ar _	wink at _
éascaigh	[vt] [vi] 1. Make easy. 2. Hurry	 expedite. éascaigh leat	 hurry along. éascaigh	 éascaigh! Quick	 quick!
seachaid	deliver
lobh	decay
corn	[vt] roll	 coil
goil	"go [Connacht][Donegal] 
Níl sé ag goil ag déanamh leas do thada (It is not going to do any good for anything) [Siadhail 1991 p.297]"
goil	weep	 cry softly
scóráil	score
áirithigh	ensure
tíolaic	bestow
taibhsigh	[vi] 1a. loom. 1b. appear	 seem. 2 (used autonomously with "do") 2a. have a presentiment (that). 2b. seems to one (that)
toirmisc	prohibit; prevent	 hinder
alp	1. swallow whole	 devoir. 2. grab.
geit	jump	 start
saor	1. (lit) raise to free status. 2. free	 liberate. 3. save	 redeem. 4. acquit.
céas	1. crucify. 2. torment. 3. suffer agony.
adhlaic	bury
soilsigh	1. shine. 2. light	 illuminate. brighten.3. enlighten.
bealaigh	grease
bearr	shave
prioc	prick
scoith	1. cut off	 lop	 sever. 2. break apart. 3. tear up. 4. shed.
comhoibrigh	cooperate	 collaborate
loic	"Flinch or fail.
Shirk or refuse.
Default or break down."
breithnigh	(jur) adjudge
géaraigh	sharpen
fuaraigh	cool; relieve; become indifferent
scean		 v.t. & i. (vn. ~adh	 gs. ~ta). Knife; stab	 cut up	 flay. Prátaí	 feoil	 a ~adh	 to cut up potatoes	 meat. Duine a ~adh	 to knife s.o.; to flay s.o. with the tongue.
cáiligh	qualify
tomhais	measure
steall	splash; pour
fuadaigh	abduct
beathaigh	feed	 nourish; rear
péinteáil	 v.t. & i. (pres. -álann). Paint. Balla a phéinteáil	 to paint a wall. Radharcra a phéinteáil	 to paint scenery.
aisghair	repeal
sainigh	define
marcáil	1. mark. 2. mark out	 plot.
gríosaigh	fire	 inflame; spur	 incite
creach	plunder
scinn	1. start	 spring. 2. dart	 rush. 
fiosraigh	inquire; inquire about; inquire into	 explore
spréigh	spread
ídigh	1. use	 use up	 wear out. 2. expend. 3. abuse	 destroy.
roll	1. roll. 2. form into roll.
seirbheáil	2	 v.t. (pres. -álann).1. Serve (with legal document)	 summons. Duine a sheirbheáil	 to serve a summons on	 to summons	 s.o. 2. Serve	 meet needs of. Is olc atá mé ~te	 I am badly served. Baoite a sheirbheáil	 to put on bait.
bíog	energize
fuaigh	1. sew. 2. bind	 stick	 unite (do	 to)
slóg	mobilize
ciap	Harass	 annoy; torment
ceartaigh	1. correct. 2. compose	 arrange. 3. expound. 4. mend.
poll	hole; pierce	 bore
caomhnaigh	cherish; preserve	 conserve
stiúir	steer
ciúnaigh	calm	 pacify
moilligh	[vt] [vi] (1. delay; slow.) ; pause	 stop temporarily
cúitigh	compensate; requite
ofráil	offer
coincheap	2	 v.t. (vn. ~adh m	 gs. & pp. ~tha).Phil: Conceive.
nótáil	[vt] to note
síothlaigh	1. strain	 filter. 2. drain away. 3. expire	 die.
srian	[vt] Bridle; curb	 restrain.
bréag	cajole
fíneáil	[vt] to fine
éigh	scream	 cry; complain
seiceáil	check	 test
gearán	complain
slánaigh	1. make whole	 redeem.  2. (a) Complete	 attain.
lagaigh	weakening	 slackening	 or reduction
aisíoc	repay	 refund
láimhseáil	[vt] Manage	 handle.
urramaigh	"[vt] 1. Respect	 revere. 2. Act according to	 observe.
Cúnant a urramú	 to observe a covenant."
cros	1. cross. 2. prohibit	 forbid. 3. contradict
crith	[vi] shake	 tremble
traenáil	[vt] [vi] to train
cart	"cleaning	 clearing	 or removing something.
Leath: Tan. To tan a strip of hide.
Scrape clean. To scrape the skin or dirt off something.
Clear away. To clean out a byre	 clear a trench	 or remove stones	 gravel	 snow	 etc.
Root. (Of swine	 etc.) To root.
= coirtigh. To peel or strip bark."
umhlaigh	humble
craobhscaoil	disseminate	 propagate	 broadcast
maoinigh	to fund
fiuch	boil
lasc	1. lash. 2. kick	 strike. 3. dash	 rush.
plúch	1. smother	 stifle. 2. (of snow) fall thickly.
lámhach	shoot
bréagnaigh	contradict	 refute	 belie
meil	grind
carn	accumulate
suaith	v.t. & i. (pp. -ite). 1. (a) Mix	 knead. Moirtéal a shuaitheadh	 to mix mortar. Taos	 plúr	 a shuaitheadh	 to knead dough	 flour. ~ go maith ina chéile iad	 mix them well together. (b) Shuffle. Na cártaí a shuaitheadh	 to make the cards. 2. (a) Knead	 exercise. Matáin a shuaitheadh	 to knead muscles. Na géaga a shuaitheadh	 to exercise the limbs. (b) Toss about	 distress	 tire. Ná ~ thú féin leis an obair throm sin	 don’t overtax yourself with that heavy work. Bhí mé suaite i ndiaidh an lae	 I was exhausted after the exertions of the day. Is mór a shuaith an saol é	 life has knocked him about a lot. 3. (a) Mix	 confuse; agitate	 disturb. An t-aer a shuaitheadh	 to disturb the air. Poll uisce a shuaitheadh	 to muddy a pool of water. Uiscí suaite	 seething waters. Tá an fharraige suaite	 the sea is agitated. Tá an tír suaite acu	 they have the country in a turmoil. Tá a aigne suaite	 his mind is fuddled. (b) Discuss	 debate. Ceist a shuaitheadh	 to discuss a question. Ag ~eadh an tsaoil	 discussing the affairs of life. Níl an scéim sin le ~eadh a thuilleadh	 there is to be no further debate on that scheme.
cúr	[vt] Chastise	 punish; scourge.
malartaigh	1. (lit) destroy. 2. change. 3. exchange	 barter.
damhsaigh	dance
comhlánaigh	complete	 complement
bláthaigh	blossom	 bloom
srac	pull	 tear
cráigh	annoy	 torment
maslaigh	insult	 affront	 abuse
mionnaigh	swear
oirnigh	A. 1. (eccles.) ordain. 2. inaugurate	 enthrone. 3. order	 arrange. B. cut in bits.
buanaigh	[vt] perpetuate
tástáil	taste
fuascail	[vt] (1. release	 deliver. 2. redeem	 random. 3. solve.)
brúcht	[vi] (1. belch	 eructate. 2. burst forth	 erupt)
cac	poop
cumhdaigh	protect
saoirsigh	A. work (stone	 wood	 metal). B. cheapen.
náirigh	shame	 embarrass
frioch	fry; fry (an egg)
séalaigh	seal
bácáil	bake
eitigh	refuse
taisc	lay up	 store
fíoraigh	"[vt] 1. Verify. Ráiteas a fhíorú	 to confirm	 bear out	 a statement. 
2. Fulfil. Tairngreacht a fhíorú	 to fulfil a prophecy. Rud nár fíoraíodh	 sth. that did not come to pass."
fíoraigh	v.t. 1. Figure	 outline. 2. Prefigure	 symbolize; portend.
ráthaigh	"[vi] to guarantee

figh	weave
cealaigh	1. do away with; hide, steal. 2. rescind, cancel. 3. consume.
dealaigh	1. part, separate. 2. distinguish, differentiate.
scall	1. scald. 2. scold. 
grian	(1) to sun oneself; (2) to solarize
agair	avenge, plead
tolg	1. attack. 2. brew, gather. 3. contract, catch.
saighid	incite
searr	stretch, extend
lom	1. lay bare; strip, denude. 2. become bare.
liostáil	enlist
meáigh	1. balance, weight. 2. estimate.
dreach	[vt]  1. Delineate, portray. 2. Theater: Make up.
tréaslaigh	congratulate
fabhraigh	[vi] (With do) Favour. Bhí an aimsir ag fabhrú dúinn, the weather was in our favour.
fabhraigh	[vi] Form, develop. Éan ag fabhrú san ubh, a bird forming in the egg. Smaoineamh, rún, ag fabhrú i gceann, in intinn, duine, an idea, an intention, forming in s.o.’s head, mind.
fuin	"[vi] to knead
<li>to set

mún	urinate
deifrigh	hurry	 hasten
eachtraigh	A. 1. fare forth. 2. banish. B. relate	 narrate.
basc	bash	 crush
deisigh	1. {† deasaigh}. 2. mend	 repair.
folmhaigh	[vt] (1. empty	 discharge	 exhaust. 2. (medical) purge	 evacuate.)
cúb	1. coop. 2. bend. 3. cower	 shrink.
ionadaigh	to represent
timpeallaigh	1. go round. 2. encircle. 3. belt	 gird. 4. circumvent.
sníomh	spin
tochail	excavate
spíon	1. comb; pull apart. 2. search	 ransack.
lochtaigh	fault	 blame
srann	1. snore. 2. snort. 3. wheeze.
dathaigh	paint
peacaigh	sin
reáchtáil	organize/ host  1. Ag ~ (i rás	 thart	 amach is isteach)	 running (in a race	 about	 in and out). 2. Damhsa	 scoil	 siopa	 a ~	 to run a dance	 a school	 a shop.
fiach	hunt
neadaigh	1. nest. 2. nestle. 3. bed	 set.
tiomnaigh	1. bequeath. 2. enjoin. 3. commend.
móidigh	vow
leon	1. sprain. 2. injure	 wound.
tiomsaigh	1. collect. 2. assemble. 3. rummage.
feistigh	1. arrange	 adjust. 2. fasten	 secure	 moor.
truailligh	corrupt	 contaminate
rop	1. thrust	 stab. 2. dart	 dash.
slíoc	1. stroke	 smooth. 2. blandish.
sciúr	1. scour	 scrub	 polish. 2. lash.
claochlaigh	1. change for the worse. 2. metamorphose.
cronaigh	"Find fault with; correct	 reprove
Notice absence of; miss
Overlook; bewitch"
bánaigh	1. whiten. 2. bleach. 3. blanch. 4. dawn. 5. empty. 6 lay waste.
téacht	freeze; congeal
coisric	consecrate
spáráil	spare
díon	v.t. 1. Protect	 shelter; cover against elements. 2. Make watertight; proof. 3. Roof	 thatch. 4. Immunize.
bruith	boil; boil (an egg)
machnaigh	think	 reflect
tál	secrete	 shed	 pour; yield milk
dréachtaigh	draft (eg. a bill)
folc	1. to bathe. 2. pour down	 shed. 3. dip	 immerse; submerge
máirseáil	1. march. 2. parade	 perambulate.
smachtaigh	control	 restrain
comharthaigh	[vt] Mark; indicate (go	 that); signify	 designate.
cumasaigh	enable	 empower
taosc	1. bail. 2. shovel.
coscair	slaughter	 mangle
ceansaigh	appease	 pacify; tame	 control
salaigh	dirty	 defile
díscaoil	[vt] [vi] Unloose	 disperse	 dissolve	 disintegrate
aibigh	ripen	 mature
insteall	inject
cócaráil	cook
dámh	concede
cnuasaigh	forage	 gather	 collect
tuaslaig	dissolve
dícháiligh	disqualify
fadaigh	"A. 1. (of fire) kindle. 2. build up	 incite. 3. erect.
B. lengthen	 extend	 prolong ( < fad)"
cneasaigh	form a scar; heal
rinc	dance
síob	1. (of wind) blow. 2. blow up. 3. drift. 4. (of bees) migrate.
táthaigh	1. weld	 solder. 3. set	 solidify. 4. Coalesce	 unite.
meath	decline
clóigh	"[vt] 1. Tame	 domesticate. Ainmhí fiáin a chló	 to tame a wild animal. Is doiligh lacha fhiáin a chló	 it is hard to domesticate a wild duck.

clóigh	[vt] Print.
díbh	dismiss
reachtaigh	legislate, enact
giorraigh	shorten
caolaigh	[vt] [vi] become thin; narrow; reduce; dilute
bolaigh	smell, scent
comhordaigh	co-ordinate
taibhrigh	dream
liúigh	[vi]  yell, shout;
taom	empty of water
tuil	[vi] Lit: Sleep, fall asleep.
tuil	A. [vt] [vi] flood
análaigh	breathe
coimhéad	guard
sruthlaigh	rinse; wash out, flush
láithrigh	v.i. (vn. -iú m, gs. -ithe). Present oneself, appear. Láithriú i gcúirt, to appear in court. ~ sé sa doras, he appeared in the door.
láithrigh	v.t. (vn. -iú m, gs. -ithe).Lit: Demolish, destroy.
gor	1. Heat, warm.  2. (a) Hatch, incubate. (b) Brood (ar, over).
scaird	squirt, gush; pour rapidly.
agóid	protest, object
coigil	spare
plab	1. plop. 2. slam, bang.
infheistigh	[vt] invest
aiséirigh	rise again
righ	stretch
clóbhuail	print, produce books
ligh	lick
buair	"grive, vex, perturb; cause worry
(also used with bí + buartha (VA) + faoi-X = X is worried)
aitheasc	1. address. 2. exhort. 3. apostrophize.
cam	twist
searg	waste	 wither
stiall	cut in strips
damnaigh	damn	 condemn
litrigh	spell
tuirsigh	tire	 weary
tarrtháil	rescue	 save
rothaigh	cycle
sléacht	kneel	 genuflect
cruaigh	harden
bligh	milk
conspóid	argue
beirigh	1. cook by boiling. 2. bake.
saill	1. salt	 cure. 2. (fig) season with wit.
stríoc	1. strike	 lower. 2. yield	 submit.
sioc	freeze
robáil	rob
cogain	1. chew	 masticate. 2. gnaw	 grind. 
satail	tread	 tramp
scréach	screech
achainigh	request
sáinnigh	"1. corner	 trap. 2. (chess) check.
Braithim cineál sáinnithe = I feel kind of trapped"
cothromaigh	even	 level; balance	 equalize
eis	[vi] to exist
snoigh	hew	 carve
tóraigh	hunt	 pursue; look	 search (for)
iontráil	[vt] [vi] enter
docht	Tighten	 bind securely.
seilg	hunt
gnáthaigh	1. make a habit of. 2. frequent. 3. (of ghost) haunt.
leadhb	[vt] (1. tear in strips	 rend asunder. 2. beat	 thrash. 3. lap	 lick.)
planc	beat	 pommel
reic	recite; sell; inform (on)
deasaigh	1. dress	 attire	 prepare. 2. settle in position	 adjust.
diúl	suck
caintigh	speak	 talk
oiriúnaigh	1. fit	 adapt. 2. fit	 suit.
creathnaigh	tremble (with fear)
buain	reap
líomh	1. grind	 sharpen; file	 smooth	 polish. 2. erode	 destroy.
muirnigh	fondle	 caress
aclaigh	[vt] 1. Limber	 exercise. 2. (Of leather	 etc.) Flex	 soften.
tuargain	pound
pacáil	pack
grean	to engrave
deil	turn	 make on lathe
teasc	[vt] Cut off	 lop; chop	 hack	 hew.
corpraigh	to incorporate
diailigh	[vt] [vi] dial
adhain	ignite	 kindle
athbhreithnigh	to review
línigh	1. line	 rule. 2. delineate	 draw.
dubhaigh	blacken
bodhraigh	1. deafen. 2. bother	 annoy. 3. deaden.
comhraic	encounter	 fight	 fall in with
ní	(3) variant of the present tense of 'déan'
crúigh	milk
sciurd	rush	 dash	 hurry
cealg	1. beguille; deceive. 2. lull to sleep. 3. (of insect) sting.
promh	prove	 test
faichill	be careful of
smiot	[vt] 1. hit	 strike	 smash. 2. chip	 chop; pare	 whittle. 3. fritter.
láidrigh	"[vt] [vi] Strengthen. 
Duine a láidriú	 to strengthen	 invigorate	 s.o. 
Deoch a láidriú	 to stiffen a drink. 
Bhí an lá ag láidriú	 the day was getting stormy.
Tá siad ag láidriú sa saol	 they are prospering in life."
díolaim	gather
reoigh	freeze
ceiliúir	"Warble	 sing.
Celebrate (e.g.	 Mass	 Christmas	 marriage	 an occasion).
Bid farewell to someone.
Fade or vanish (e.g.	 health	 ghost	 color)."
achair	beseech
cuar	[vt] [vi] (curve)
priontáil	print
ramhraigh	1. fatten. 2. thicken. 3. batter	 stupefy.
stoll	tear	 rend
iomair	row
dligh	"To be entitled to or deserve. 2. To be obligated to or liable for. 3. Used with prepositions to express entitlement or obligation.
dligh + do + [object] = Entitled to or due to.
dligh + de + [object] = Owing or obligated to.
dligh + ar + [object] = Obligated to (perform an action)."
fóin	serve; be of use; avail
ransaigh	"[vi] ransack	 rummage	 search
{† ransáil}"
slad	plunder
mallaigh	[vt] [vi] curse
marcaigh	ride
bisigh	1. improve. 2. increase	 prosper.
plódaigh	crowd	 throng
iaigh	close	 stop	 join
fairsingigh	v.t. & i. 1. (a) Widen	 extend. Poll	 doras	 a fhairsingiú	 to widen a hole	 a door. Bróg a fhairsingiú	 to stretch a shoe. Teach	 spás	 a fhairsingiú	 to enlarge a house	 a space. (b) Broaden	 expand. An intinn a fhairsingiú	 to enlarge the mind. Tuairim	 ráiteas	 a fhairsingiú	 to amplify an opinion	 a statement. 2. (a) Become plentiful. Tá an bia ag fairsingiú	 food is becoming more plentiful. (b) Become liberal. Fairsingiú chun féile	 to expand towards generosity.
bruíon	fight
cardáil	1. (textiles) card. 2. discuss.
slis	[vt] [vi] (cut	 slice; whack)
cásaigh	lament; sympathize	 condole; grumble; deplore
doir	(husbandry) bull
snasaigh	polish	 gloss
tionlaic	accompany	 escort
soiprigh	nestle	 snuggle	 down
altaigh	give thanks (to God for sth.)
bioraigh	1. point	 sharpen.
feith	1. look at	 watch. 2. guard. 3. (VN + prep) wait	 expect
sóinseáil	change
daor	1. enslave. 2. convict	 condemn
soirbhigh	make easy	 pleasant
clóscríobh	type
gróig	huddle
ualaigh	load	 burden	 encumber
aifir		 v.t. (pres. -fríonn	 vn. ~t	 pp. -feartha).Rebuke	 reproach; punish. Rud a ~t ar dhuine	 to rebuke	 to punish	 s.o. for sth. Nár aifrí Dia orm é	 may God forgive me for (saying	 doing) it. Ná h~ a chuid ábhaillí ar an leanbh	 don’t blame the child for playing pranks.
friotháil	attend	 minister; entertain as guest
naomhaigh	hallow	 sanctify
troisc	fast
téarnaigh	escape
cnead	pant
cniotáil	craft
foighnigh	have patience with; bear
uaisligh	ennoble
righnigh	1. toughen; persevere. 2. linger	 delay.
beachtaigh	correct. (with ar) criticize.
tochais	scratch
íobair	sacrifice.
bearnaigh	[vt] (1. breach. 2. broach	 tap.)
adhair	adore	 worship
dall	1. blind. 2. dazzle; stupefy. 3. (of opening) block; camouflage
deighil	divide
ionramháil	Handle	 manage; manipulate	 manoeuvre; humour.
snigh	flow
beoigh	animate
rámhaigh	row
díospóid	dispute
brandáil	[vt] brand
stiúg	"[vi] expire / perish / die
<small>stiúg sí = she snuffed it</small> "
toibhigh	levy	 collect
traoith	abate	 subside
tromaigh	1. become heavier. 2. Make heavier	 add weight to. 3. intensify. 4. deepen.
dord	hum
eisc	excise
feoigh	wither	 decay
aibhsigh	[vt] 1. enlarge (on); emphasize. 2. heighten (color)
speach	(of animal) kick; (of gun) recoil.
uimhrigh	1. number.
cúnaigh	help
cogair	whisper
coir	tire
taiscéal	[vt] [vi] 1. Explore	 examine; reconnoitr
tiubhaigh	thicken
tnúth	"1. Envy. Rud a thnúth do dhuine	 to envy s.o. sth. Níor thnúth mé riamh dóibh é	 I never begrudged it to them. Ná bígí ag ~ le chéile	 don’t be envious of one another; don’t be vying with one another. Níl mé ag ~ a ndóighe dóibh	 I don’t envy them their situation. 
2. Long for	 desire. Ag ~ le rud	 eagerly expecting sth. Ag ~ leis an lá	 yearning for the day. Bhí mé ag ~ le do theacht	 I was earnestly hoping you would come. (Var:~aigh)"
meathlaigh	"[vi] to degenerate

plandaigh	(hortic) plant
feighil	watch
sleabhac	droop, wilt
smeach	[vt] [vi] (flip, flick; click, smack; gasp)
spor	spur
báistigh	rain
creath	tremble
gníomhachtaigh	activate
casaoid	complain
adhmhol	extol, eulogize
air	plough
campáil	"[vi] to camp
<li>láithreán campála = camp site
maistrigh	churn
mungail	1. munch	 chew. 2. (of speech) slur	 mumble
suncáil	sink
cumaisc	mix
aeráil	aerate
blosc	Crack	 explode
cigil	tickle
faisnéis	relate
súraic	suck
gréisc	grease
tóch	dig
cónaisc	connect	 conjoin
broim	fart
diall	incline towards
diúraic	cast	 shoot	 project (a missile)
athnuaigh	renew	 refresh
scrobh	(of eggs) scramble
breoigh	[vt] [vi] (1. glow. 2. heat. 3. enfeeble.)
smol	blight
stuáil	[vt] [vi] (stow; pack	 stuff	 pad; cover securely)
achoimrigh	[vt] summarize; recapitulate
sir	"Lit:1. (a) Travel through	 traverse. 
Dá ~imis Éirinn	 if we were to travel Ireland. Iasc shireas an sáile	 a fish that roams the sea. (b) Seek out	 have recourse to. Shir mé an Tiarna	 I sought the Lord. 
2. (a) Seek	 ask for. An té a shireas ní ar neach	 whoever asks someone for something. (b) Beseech	 implore. ~im an tAthair	 I beseech the Father."
dath	(1) to allocate (to); (2) to colour	 to dye	 to paint
glasáil	lock
rómhair	dig
fuirsigh	struggle
caígh	weep [Hughes verb type: cloígh; present caíonn]
comóir	"[vt] 1. Convene	 assemble. Aonach	 cruinniú	 a chomóradh	 to convene a fair	 a gathering. 
2. Celebrate. Féile	 ócáid	 an Cháisc	 a chomóradh	 to celebrate a feast	 an occasion	 Easter. Do chomóradh glóire Dé	 for the greater glory of God. 
3. Accompany	 escort. Duine a chomóradh abhaile	 go teach an phobail	 chun an stáisiúin	 to escort s.o. home	 to the church	 to the station. Rinne sé mé a chomóradh giota den bhealach	 he accompanied me part of the way."
forógair		 v.t. (pres. -graíonn; vn. ~t f	 gs. & pp. -artha). 1. Proclaim	 decree. 2. Forewarn.
iomdhaigh		 v.t. & i. Lit: Increase	 multiply.
damhnaigh		 v.t. Materialize; shape	 form.
fuighill	(lit) utter	 speak; pronounce (judgment)
leanúint	(verb) to follow or adhere to something.
camhraigh	[vi] (Of fish	 meat	 etc.) Become tainted.
barúil	[vi] (think	 be of the opinion (that) )
caithrigh	[vi] 1. Reach puberty. 2. Develop	 expand.
drantaigh	[vi] 1. Snarl	 growl. 2. Threaten.
conclúidigh	[vi] Conclude.
aigleáil	[vi] haggle
smiog	[vi] Pass out	 expire	 die. Shíl mé go ~fainn	 I thought I’d die. ~tha ag an toit	 suffocated with the smoke.
osnaigh	[vi] Sigh.
imirc	"[vi] to migrate

fómhais	[vt] ( (jurisprudence) (of costs) tax)
corcraigh	[vt] (1. make or dye purple. 2. bloody)
íoslaghdaigh	[vt] (1. minimize; play down, understate; 2. (computer) shrink to taskbar)
asúigh	[vt] (adsorb; aspirate)
baslaigh	"[vt] (baste, beat)
{†√ baslú [m]}
imlínigh	[vt] (outline)
bréitseáil	[vt] [vi] (1. breach	 break. 2. vomit.)
bladair	[vt] [vi] (1. cajole. 2. adulate	 flatter.)
ionsáigh	[vt] [vi] (insert)
fothaigh	[vt] [vi] 1. Lay foundation of	 found	 establish. 2. Support	 sustain.
síolaigh	[vt] [vi] 1. Seed	 sow. 2. Disseminate	 spread.
breáthaigh	[vt] [vi] beautify; become beautiful	 fine
líomhain	[vt] 1. Allege	 impute (ar	 against). 2. Revile.
fánaigh	[vt] 1. disperse; 2. Dwindle	 diminish.
leamh	[vt] 1. Lit: Render impotent. 2. Render tasteless.
urghráinigh	[vt] 1. Loathe	 abhor. 2. Terrify.
ionsúigh	[vt] absorb
aigéadaigh	[vt] Acidify.
díoghail	[vt] Avenge	 punish.
imghabh	[vt] avoid	 evade	 shun
bréadaigh	[vt] braid
tuaigh	[vt] Chop (with axe).
códaigh	[vt] codify; code	 encypher
iomlánaigh	[vt] complete	 integrate
díreoigh	[vt] Defreeze.
ionchuir	"[vt] enter (data) into database
[verb form can be analyzed as ion [L] + cuir]"
óraigh	[vt] gild
athmhúnlaigh	[vt] Remould	 remodel
sampláil	[vt] sample (music	 )
clab	[vt] swallow greedily
meaisínigh	[vt] to machine
goiligh	[vt](Of fish) Gut.
réimnigh	1. advance	 progress. 2. arrange in order.
cranraigh	"1. Become knotty; harden
2. Make or grow callous"
eamhnaigh	1. Double. 2. Sprout	 pullulate.
truaigh	1. make lean; emaciate. 2. become thin; waste away
neodraigh	1. neutralize. 2. neuter.
aisig	1. restore	 restitute. 2. vomit
maothaigh	1. soften	 make tender.
scealp	1. splinter; chip. 2. snatch.
aiceannaigh	accentuate
achtáil	actualize
agaill	address	 speak to
adhaltranaigh	adulterate
aeraigh	aerate
fortaigh	aid	 comfort
aeroiriúnaigh	air-condition
achomharc	appeal
aisc	ask	 seek
adamhaigh	atomize
deimhneasc	aver
caidrigh	be on friendly terms with
dréim	climb
comhréitigh	compromise	 settle
clíth	copulate
gág	Crack	 chap.
brúisc	crush
tiomain	curse	 swear
dreoigh	decay
aghloit	deface
adhmhill	destroy utterly
adhnáirigh	disgrace
rionn	divide
adhfhuathaigh	dread	 abhor
eisiacht	eject
fleadhaigh	feast
ábhraigh	fester
glinnigh	fix	 secure	 scrutinize	 glint
comhaill	fulfill (a promise	 obligation); observe (a rule)
tiomairg	gather	 collect
tacair	glean
cnaígh	gnaw
seachránaigh	go astray; err
gogail	gobble
aoirigh	herd
tórraigh	hold obsequies of
adharcáil	horn	 gore
iomáin	hurl
triosc	interrupt
iombháigh	iombháigh	 v.t. & i. (pres. -ánn	 fut. -áfaidh; vn. iombhá	 pp. -ite).Submerge	 swamp; drown	 drench. Duine a iombhá	 to immerse s.o. in water	 to duck s.o. Bád a iombhá	 to swamp a boat.
uaim	join together
sop	light with straw
scíthigh	Lit:(Used autonomously) Become tired	 exhausted.
áibhligh	magnify
máistrigh	master
treáigh	pierce
taighd	poke	 research	 dig [present taigheann; model = tuig]
bailc	pour down; press down
racáil	rack
ciondáil	ration
athchúrsáil	recycle
frisnéis	refute
táinsigh	reproach
teasairg	rescue
iomlaisc	roll about
aibhligh	scintillate
scrábáil	Scribble	 scrawl; scratch.
faoisc	shell
smid	smid1	 f. (gs. ~e	 pl. ~eanna).1. Breath	 puff. Níl ~ ghaoithe ann	 there is not a breath of wind. Níor fhan ~ ionam	 I was completely out of breath. 2. Syllable	 word. Níl ~ as	 there is not a sound out of him. Ná bíodh ~ as do bhéal	 don’t breathe a syllable. Ná habair ~	 don’t say a word. S.a. béal 1(c).
smid	smid2	 v.t. 1. Dress (flax). 2. Th: Make up. 3 = smiot.
agaigh	space out
sleáigh	spear
strapáil	strap
fuaidrigh	stray
rúisc	strip; shake	 stir
leaindeáil	to land
och	to sigh or groan
tochrais	to wind (clock	 yarn)
ascain	travel	 proceed towards	 journey
comhaontaigh1	Unify; unite
mainnigh	v.i. (vn. -nneachtain).Jur: Default (i	 in).
aothaigh	v.i. Pass crisis.
díolmhaigh	v.t. (vn. -mhú m	 gs. -ithe).Jur: Exempt.
seachtraigh	v.t. Exteriorize	 externalize.
urlaic	vomit
maoscail	wade
tonach	wash
uachtaigh	will	 bequeath
cneáigh	wound
buígh	yellow
	
	
brógstrapáil	to tie shoes
comhaontaigh	(1) to unite	 unify; (2) to agree	 assent (with	 to); (3) to cohabit (with)
atreoraigh	redirect
	
scor	vt. vi. (1) to cut	 slash	 slice; (2) to score	 notch
	
	
	
	
	
	
	
traoch	overcome	 subdue	 wear out
	
samhail	[† samhlaigh] vt. (1) to imagine
fuathaigh	1. hate. 2. abandon through dislike
raiceáil	vt. (1) to wreck something
pionósaigh	vt. (1) to impose a penalty on someone; (2) to penalize	 punish someone
athchóirigh	vt. (1) to rearrange	 re-adjust; (2) to restore	 renovate; (3) to adapt; (4) to alter
scáil	vt. (1) to cast a shadow; (2) to reflect; (3) to shine; (4) to tint
galaigh	vaporize	 steam
cothabháil	[† cothaigh] 1. feed	 nourish	 sustain. 2. stir up. 3. maintain	 hold fastscanradh	fright
is cosúil	it seems
cearr	A. 1. Injury, wrong. 2. Mental derangement. B. Wrong
tástálacha	tests
éadrom	light; not heavy
miongháire	Smile; soft chuckle.
eile	a3. Other, another; next, more, else. 
maith	good
beag	small
céad	first
amháin	only
ceart	right, correct
alt	(1) alto (musical term)
te	hot
céanna	same
nua	new
óg	young
leor	sufficient
fada	long
léir	clear
ard	high, tall
uile	all
éigin	certain; some
minic	frequent, often
iomlán	complete, total
cóir	Just, proper; decent, honest.
díreach	1. Straight, direct
lán	full
náisiúnta	national
éagsúil	different
sásta	satisfied
breá	fine, excellent
áirithe	certain, particular
áitiúil	local
fíor	true
gearr	1. short. 2. Near, close
cosúil	similar, like
saor	free
luath	1. Quick, fast, speedy. 2. early, soon
deas	nice
fás	Waste, vacant, empty, void. S.a. FUIGHEALL1. 2. Wild, luxuriant.
láidir	strong
tábhachtach	important
beo	alive
dubh	black
bocht	poor
poiblí	public
gaoth	(1) wise, sagacious, shrewd, intelligent
iontach	wonderful
ionann	identical
cinnte	certain
glan	clean
mór	large, big
olc	bad/evil
bog	soft
leath	(1) lying, turned, to one side; (2) one-sided, partial; (3) half-, hemi-, semi-; (4) half-grown; (5) one of two, of a pair
sóisialta	social
uasal	(1) noble, high-born; gentle, gentlemanly; (2) noble, precious, fine; (3) sacred to the dead, hallowed, enchanted; (4) as title, Mr.
deacair	hard, difficult
grian	(1) solar, sun-
dócha	probable
úr	fresh/new
deireanach	last
cuí	Fitting, proper.
bán	white
fóill	(in adv. phrase) go fóill (yet, still)
mó	greater
speisialta	special
dearg	red
slán	safe
idirnáisiúnta	international
déanach	late
domhain	deep
réidh	ready/smooth
oifigiúil	official
páirteach	1. Participating, sharing. 2. sympathetic. 3. partial.
geal	bright
láithreach	immediate
marbh	dead
álainn	beautiful
géar	sharp
gar	near
trom	≈ heavy
dáiríre	serious
deimhin	sure
glas	green
soiléir	clear
pearsanta	personal
sean	old
daonna	human
leathan	broad, wide
gairid	1. short. 2. Near, close. 
íseal	low
polaitiúil	political
Caitliceach	Catholic
mall	slow
ábalta	able, able-bodied
ginearálta	general
riachtanach	necessary
rialta	regular
nocht	naked
trua	"1. (a) Pitiable; miserable, wretched.
1. (b) (With copula) It is a pity (that).
2. (a) Lean.
2. (b) Thin, emaciated; wasting."
cruinn	accurate
fuar	"1. Cold. (a) (Of temperature, feeling). (b) Not heated, allowed to cool after cooking. (c) Sensitive to cold. (d) Slow to absorb heat. (e) Chilling, depressing. (f) Without ardour. (g) Apathetic. (h) Vain, profitless. (i) Without interest. (j) Dead.
2. Raw, uncooked.
3. (Of masonry) Dry."
breac	speckled, spotted
gorm	blue
ciúin	quiet; calm, silent, still
crua	hard
clé	left
coitianta	common
nádúrtha	natural
iomaí	2. (Used predicatively) Many.
teann	tight
binn	melodious
déanta	done
domhanda	1. Terrestrial. 2. mundane, worldly. 3. world-wide, global
éifeachtach	effective
lasmuigh	outside
ceithre	four
aisteach	1. (a) Peculiar, queer. (b) Wonderful, surprising. 2. Droll.
bunúsach	basic
buí	yellow
suntasach	1. Noticeable, remarkable; prominent, distinctive. 
dona	bad
daingean	"1. Fortified, solid; strong, secure.
2. Fixed, fast; firm.
3. Steadfast, constant; firm of purpose.
4. Intense."
lag	weak
cultúrtha	cultural
príobháideach	private
anuraidh	(time) last year
miste	pred. a. (Combined form of measa de:olc28. Used with copula). 1. Is ~ (do), it matters (to). Is beag is ~ faoi, it matters little about it. Ní ~ a rá (go), it is no harm to say (that). Níor mhiste smaoineamh air, it would be well to think about it. Ar mhiste ceist a chur air faoi? Would it be all right to ask him about it? Is ~ an tír, don tír, é, it matters to the country. Is dom is ~ é, it certainly matters to me. Ní ~ duit cad é a dúirt mé, it doesn’t matter to you what I said. Ar mhiste duit fanacht tamall? Would it be inconvenient for you to stay a while? Rud nár mhiste dó, as well he might. 2. (With le) Is ~ liom faoi, I mind, care, about it. Ní ~ leo ann nó as mé, they don’t care whether I exist or not. Más ~ leat suí, if you like to sit. An ~ leat? Do you mind? Mura ~ leat, if you don’t mind. An dtiocfaidh tú linn? Ní ~ liom. Will you come with us? I don’t mind.
oiriúnach	1. suitable, fitting. 2. fit, ready. 3. agreeable, well-behaved, respectable.
iomchuí	appropriate
caol	narrow/slender
caoin	gentle
leanúnach	continuous
simplí	simple
neamhspleách	[neamh-] + [?spleách] = independent
traidisiúnta	traditional
Ceilteach	Celtic
dílis	"1. Own; proper («do», to).
2. Genuine; reliable, solid.
3. Loyal, faithful.
4. Dear."
dorcha	dark
cúramach	careful
éasca	Swift, nimble; free, fluent, easy; ready, prompt.
difriúil	different
freagrach	responsible
furasta	easy
gnóthach	busy
ceathrú	fourth
tobann	sudden
buan	permanent
bliantúil	annual
amárach	tomorrow
eacnamaíoch	economic
gnách	usual
dian	severe
saibhir	rich
aitheanta	recognized
oscailte	open
liteartha	literary
gníomhach	active
tirim	dry
Protastúnach	Protestant
folamh	empty
fairsing	1a. wide, extensive; ample, spacious. 2a. plentiful, abundant. 2b. liberal, labish, bountiful.
cáiliúil	famous
acmhainneach	resourceful
garbh	rough
Críostaí	Christian
tíor	dry
liath	gray
uafásach	terrible
sóisialach	socialist
naofa	holy
ciontach	guilty
sonrach	specific
deonach	voluntary
spéisiúil	interesting
lárnach	central
forleathan	extensive
tréan	strong
stairiúil	historical
suimiúil	interesting
fásta	[VA-fás] grown
gránna	ugly
lom	1. bare. 2. thin. 3. close.
iondúil	usual, customary
míleata	military
sibhialta	civil
donn	brown
fliuch	wet
gairmiúil	professional
claon	"1. Inclined; sloping, slanting.
2. Bent down, reclining. 
3. (With «ar», «chun») Tending, prone, to; partial to. 
4. Perverse. "
casta	"2. Twisted, wound.
3. Complicated, intricate, involved.
4. Gnarled, bent; wizened."
dlúth	"1. Close, compact; dense, solid.
2. Close, tight; near.
3. Intense, earnest."
teoranta	limited
tinn	sick
réigiúnach	regional
buíoch	grateful
réasúnta	reasonable
cuimsitheach	1. comprehensive, inclusive. 2. Gram: Restrictive
inmheánach	internal
eachtrach	foreign
sealadach	temporary, provisional
dúchasach	native
straitéiseach	strategic
laethúil	daily
tapa	fast
sinsearach	senior
dall	blind. 2. (a) Dull, uninformed; in the dark
mín	smooth
praiticiúil	practical
cáilitheach	qualifying
socair	Quiet, still; calm, unruffled; easy, steady; settled; at rest.
daonlathach	democratic
rua	red
fiáin	wild
aoibhinn	delightful, blissful
cóngarach	near
grinn	accurate, precise
tuirseach	tired
annamh	"1. Rare, infrequent.
2. Lit: Lonely, desolate."
uaigneach	lonely
maol	"1. (a) Bare, bald.
1. (b) Bare, unprotected.
2. (a) Hornless.
2. (b) Cropped.
3. Roofless, dismantled.
4. Edgeless, blunt.
5. (a) Flattened.
5. (b) Geom: Obtuse.
6. (Of tone) Flat.
7. Dense, obtuse.
8. Late in day.
9. (Intensifying)"
cumasach	1. capable, powerful. 2. (as intensifying adjective)
bréan	rotten
mion	detailed
salach	dirty
ríoga	royal
náisiúnach	national
síor	eternal
pósta	married
abhus	(1) here; (2) on this side
suarach	1. Paltry, petty, insignificant; mean, contemptible. 2. Airy, frivolous.
buartha	worried
acadúil	academic
luachmhar	valuable, precious
sásúil	satisfactory
briste	broken
galánta	elegant
fionn	fair/blonde
daor	expensive, dear
nua-aimseartha	[nua-] + [aimseartha] = modern
cinnteach	certain, sure
dátheangach	[dá-] + [teangach] = bilingual
síoraí	Eternal, perpetual; unceasing, continual; constant, persevering.
daite	colored
reachtúil	statutory
contúirteach	dangerous
sona	happy
dealbh	(1) destitute, bare, empty, bleak; (2) bleak weather
tanaí	"1. Thin. (a) Of little thickness. (b) Fine. (c) Lean. (d) Flimsy. (e) Sparse. (f) Weak, watery. (f) Metall: Miotal tanaí
2. Shallow."
cruthaitheach	creative
plaisteach	plastic
suite	situated; fixed; stocky
poblachtach	republican
cumhachtach	powerful
cúng	narrow
rúnda	1. Mystical, mysterious. 2. Secret, confidential.
Oilimpeach	Olympic
dearfach	affirmative, positive
dúnta	closed
ábhartha	material; relevant
teicniúil	technical
comhairleach	advisory
órga	golden
gasta	quick
bréagach	false
macánta	honest
Rómhánach	Roman
lánaimseartha	[lán] + [aimseartha] = full-time
réasúnach	reasonable
fánach	random
sábháilte	safe
mear	quick
bríomhar	lively
coiriúil	criminal
ársa	ancient
leictreach	electric
foirmiúil	formal
iníoctha	[in-] + [VA-íoc] = payable, due
infheidhme	Fit for service; able to function; fit, able-bodied.
milis	sweet
dlíthiúil	legal
uachtarach	1. upper, top. 2. Higher, superior.
ainmneach	1. Gram: Nominative.
fíochmhar	fierce
críonna	"1. (a) Wise, prudent.
1. (b) Shrewd, sagacious.
1. (c) Thrifty.
2. Grown-up, mature.
3. Old."
fiúntach	Worthy; decent, respectable; generous.
dána	bold, daring
imeartha	"[VA-imir] = 
Tricky, prankish.
Practised, clever.
Tried, exhausted.
(play-); (playing-)"
ramhar	fat
gann	scarce
cairdiúil	friendly
taitneamhach	enjoyable
aosta	old
bainteach	"[PrepositionalAdjective] (With «le»)
Involved in, relative to."
brónach	sad
beacht	precise
cliste	clever
séimh	gentle
bródúil	proud
diúltach	negative
dearfa	positive
measartha	moderate
eolach	knowledgeable
tais	wet
clasaiceach	classical
corr	odd
gaolmhar	related; cognate
Spáinneach	Spanish
spioradálta	spiritual
rannpháirteach	participative
tugtha	"[VA-tabhair] = 
Spent, exhausted.
Given to, prone to."
dóchasach	hopeful
docht	tight
aduaidh	(direction) northwards
greannmhar	funny
compordach	1. Comfortable. 2. Comforting; agreeable, pleasant.
dleathach	"1. Lawful, legal.
2. Valid, genuine.
3. Just, proper."
feasach	Knowing, knowledgeable, well-informed.
caoch	blind
seachtrach	External, exterior.
cam	crooked
aerach	"1. Airy.
2. (a) Light-hearted, gay; lively, frolicsome. (b) Flighty, giddy."
achomair	"1. Concise, brief.
2. Summary.
3. Near, close to."
fírinneach	truthful
leictreonach	electronic
clúiteach	famous
tromchúiseach	[trom] + [cúiseach] = serious
fial	generous
bídeach	tiny
tograch	"1. Ready, eager.
2. Predisposed, tending («do», to)."
lách	Pleasant, affable, sociable, friendly.
bacach	lame; halting, imperfect [+n]
folláin	Healthy; wholesome, sound.
comhaimseartha	[comh] + [aimseartha] = contemporary
feiliúnach	"Suitable; fitting, fit, becoming.
Obliging, helpful."
práinneach	urgent
inniúil	"[PrepositionalAdjective] (With «ar», «chun», «do»)
1. Able, fit, for.
2. Equipped, ready, for."
eachtrannach	foreign
baileach	"1. (Mainly used adverbially) Exact.
2. Frugal, thrifty."
míshásta	[mí-] + [sásta] = dissatisfied
sainiúil	distinctive
stuama	"1. Sensible, level-headed; self-possessed, staid, prudent.
2. Skilful, patient, steady."
ealaíonta	artistic
millteanach	terrible
moch	early
blasta	tasty
seachtainiúil	weekly
cuimhneach	memorable
cróga	"Brave.
Hardy; lively, spirited."
Atlantach	Atlantic
marfach	deadly
eaglasta	ecclesiastical
slachtmhar	Well-finished, neat, tidy
díomhaoin	"1. Idle. (a) Worthless, vain. (b) Unoccupied, unemployed.
2. Unmarried."
dathúil	1. Colourful; comely, beautiful. 2. Generous.
toll	hollow
uirbeach	urban
singil	single
díograiseach	diligent
tuisceanach	understanding; wise, discerning; thoughtful, considerate.
coimhthíoch	foreign, alien
príomha	primary
moltach	praiseworthy
úsáideach	useful
righin	stiff, rigid
tionsclaíoch	industrial
tarraingteach	attractive
ciallmhar	sensible
cineálta	kind
searbh	bitter
éigeantach	mandatory
toilteanach	willing
bunreachtúil	constitutional
aireach	attentive
tachtach	choking
eolaíoch	scientific
glic	Clever, ingenious; shrewd, sagacious; crafty, cunning.
ceadaithe	permitted
mithid	"1. Pred. a. (With copula) It is (high) time.
2. s. (pl. mithidí). Due, convenient, time."
gleoite	cute, lovely
amaideach	foolish
follasach	obvious
tubaisteach	disastrous
imníoch	anxious
sóisearach	junior
inchurtha	[in-] + [VA-cuir] = comparable
suaimhneach	peaceful
oilte	skilled
amhrasach	suspicious
corrach	unsteady
baolach	dangerous
caighdeánach	standard
Albanach	Scottish
samplach	exemplary
millteach	destructive
indéanta	[in-] + [VA-déan] = Practicable; fit to be done.
flúirseach	abundant
breithiúnach	judicial
balbh	mute
saolta	worldly
morálta	moral
beannaithe	blessed
gruama	Gloomy, sad; morose, despondent; sombre, cheerless.
iargúlta	"Backward, remote, isolated.
Outlandish, wild, terrible."
umhal	humble
gearánach	complaining
ionraic	"1. Upright, honest.
2. Artless, guileless."
núicléach	nuclear
cathartha	civil
conspóideach	controversial
ceanúil	affectionate
nimhneach	poisonous
uatha	(grammar) singular
bodhar	deaf
orgánach	(noun) an organism; (adjective) organic.
neamhghnách	[neamh-] + [gnách] = unusual
foirfe	1. Complete, perfect. 2. Aged, mature. 3. Gram:An aimsir fhoirfe, the perfect tense.
brocach	badger-like
gonta	[VA-goin] concise
cneasta	1. Honest, sincere. 2. Decent, seemly. 3. Mild-mannered. 4 (Of weather) Mild, calm.
sláintiúil	healthy
feargach	angry
ceimiceach	chemical
borb	"1. Fierce, violent; rude.
2. Coarse, strong, pungent.
3. Rank."
caillte	[VA-caill] lost
ait	strange, odd
múinte	polite
coimeádach	conservative
íochtarach	lower
páirtaimseartha	[páirt-] + [aimseartha] = part-time
costasach	expensive
fuinniúil	energetic
ainnis	miserable
cráifeach	pious, devout
mídhleathach	[mí-] + [dleathach] = illegal
lofa	rotten
tráthúil	timely
muinteartha	"Belonging to a household or community; associated, familiar.
Friendly."
meabhrach	"1. Mindful, recollective.
2. Reflective, thoughtful; intelligent.
3. Conscious, aware."
béasach	polite
proifisiúnta	professional
leamh	"1. Lit: Soft; weak, impotent.
2. Tepid; tasteless, insipid.
3. Lifeless, dull, uninteresting.
4. Soft-witted; inane, silly."
dóite	burnt
údarásach	authoritative
dochreidte	[do-] + [VA-creid] = unbelievable
oideachasúil	educational
barúlach	opinionated
iomráiteach	famous
fonnmhar	eager
néata	neat
sleamhain	slippery
úrnua	brand new
fiosrach	curious
náireach	shameful
gnéasach	sexual
lonrach	bright, shining
líonmhar	numerous
neirbhíseach	nervous
daoineach	sociable
liobrálach	liberal
ansa	dearest, most beloved
smaointeach	thoughtful
glórach	noisy
síochánta	peaceful
scoite	[VA-scoith] = isolated
misniúil	brave
dúthrachtach	diligent
araile	"certain
, a. & pron. 1. Lit:~ lá, on a certain day. ~ aimsir, on one occasion. In ~ fásach, in a certain wilderness. 2. Lit: Le h~, with each other. Ó láimh go h~, from one hand to the other. 3. Agus ~, et cetera."
indíreach	[in-] + [díreach] = indirect
maorga	1. Stately, dignified, imposing. 2. Sedate, quiet. 
ilghnéitheach	[il-] + [gnéitheach] = diverse
nua-aoiseach	[nua-] + [?aoiseach] = modern
cónaitheach	residential
achrannach	contentious
gealgháireach	[geal] + [gáireach] = cheerful
inghlactha	[in-] + [VA-glac] = acceptable
deimhneach	"1. Certain.
2. Positive."
léannta	learned
aonarach	solitary
téarmach	terminal
spreagúil	inspiring
fileata	poetic
fónta	worthwhile, sound
Oráisteach	Orange (related to the Orange Order)
cearnach	square
flaithiúil	generous
gafa	[VA-gabh] = engaged
snasta	polished
diaga	divine
sámh	Peaceful, tranquil; easy, restful; pleasant.
báúil	sympathetic
rathúil	successful
eisceachtúil	exceptional
comhtháite	integrated
uaine	green
feiceálach	noticeable
neamhshuim	Lack of interest, disregard, indifference. neamhshuim a dhéanamh de rud, to disregard, make light of, sth.; to treat sth. as unimportant.
torthúil	fertile
bradach	thieving
ingearach	vertical
fóirsteanach	appropriate
míosúil	monthly
diamhair	Dark, obscure; occult, mysterious; secluded, solitary; eerie, weird, lonely; fearsome.
cinniúnach	fateful
dainséarach	Dangerous.
cabhrach	helpful
seasta	[VA-seas] = 2. (a) Standing, supporting. (b) Steady, permanent, regular. (c) Delighted.
muiníneach	confident
croíúil	heartfelt
soineanta	"(Of weather) Calm, clement, fair.
(Of expression) Pleasant, serene.
Innocent, guileless; simple, naive."
seasmhach	Steadfast, firm, constant.
aineolach	[ain-] + [eolach] = ignorant
seafóideach	foolish
adamhach	atomic
cumhra	fragrant
suaithinseach	remarkable
tuairimeach	speculative, opinionated
réadúil	realistic
neodrach	neutral
réabhlóideach	revolutionary
intuigthe	[in-] + [VA-tuig] = Understandable, intelligible; implied, implicit.
tostach	quiet
sollúnta	solemn
ceolmhar	musical
solúbtha	[so-] + [VA-lúb] = Flexible, pliable, supple, adaptable.
duairc	Morose, cheerless, joyless, gloomy. 
iomadúil	numerous
comhthreomhar	parallel
éagórach	unjust
magúil	mocking
imeallach	marginal
comhfhreagrach	corresponding
leasc	reluctant
líofa	"(a) Ground, sharpened, polished by friction.
(b) Fluent, polished.
(c) Keen, eager.
(d) Sharp, speedy."
grámhar	1. Loving, tender, affectionate. 2. Lovable, amiable.
dúshlánach	challenging
corraitheach	exciting
glé	bright, clear
téagartha	"1. Substantial, stout, bulky.
2. Sheltered, warm, comfortable."
contráilte	contradictory
seicteach	sectarian
intíre	domestic
mealltach	enticing
tapúil	quick
tairbheach	beneficial
allta	wild
onórach	honorable
scanrúil	scary
dealraitheach	apparent, likely
dícheallach	diligent
teibí	abstract
gléasta	dressed
dubhach	gloomy, sad
aibí	ripe, mature
trialach	trial, experimental
damanta	damned
teolaí	1. warm, cosy, comfortable. 2. fond of comfort
tofa	[VA-togh] = elected. 2. Choice.
glórmhar	glorious
faiteach	timid
meidhreach	cheerful
leochaileach	fragile, vulnerable
bándearg	[bán] + [dearg] = pink
amh	raw, uncooked
neamhchoitianta	[neamh-] + [coitianta] = uncommon, rare
corcra	purple
trócaireach	merciful
siúráilte	sure
críochnaitheach	final, definitive
goirt	salty
méith	(noun) fat meat; (noun) richness or fertility, abundant yield; (adjective) fat, rich, fertile, mellow, juicy; (noun) swollen sea.
naimhdeach	hostile
foighneach	patient
leadránach	boring
fuilteach	bloody
faiseanta	fashionable
dearóil	"1. Frail, feeble; puny, insignificant.
2. Cold, sensitive to cold; bleak, chilly.
3. Mean, lowly; needy, poor; wretched."
santach	"1. Greedy. Covetous, avaricious.
2. Intensely eager."
doiléir	[doi-] + [léir] = obscure, unclear
criticiúil	critical
fionnuar	"1. (Of air) Cool, refreshing.
2. (Of temperature) Cool, moderate.
3. (Of garment) Cool, light.
4. (Of disposition) Calm, serene."
fadálach	procrastinating
éachtach	notable, remarkable
diongbháilte	determined
iomarcach	excessive
Ultach	Ulster (adj.)
substaintiúil	substantial
ceadmhach	permissible
iata	[VA-iaigh] = closed
leisciúil	1. Lazy, slothful. 2. Reluctant, loath. 3. Shy.
aimseartha	modern
lochtach	faulty
áiféiseach	absurd
tiomanta	"[VA-tiomain] = (a) Sworn; set, determined.
(b) (In asseverations)"
fabhrach	favorable
comónta	common
dúbailte	double
íon	(noun) pure; (adjective) guileless, sincere.
áisiúil	convenient
spleodrach	lively
glinn	Clear, distinct, vivid.
cúthail	1. bashful, shy. 2. Diffident, modest; quiet.
dúr	stubborn
collaí	carnal, sexual
anaithnid	Strange, unknown.
scaipthe	scattered
mífhoighneach	[mí-] + [foighneach] = impatient
éiginnte	"1. Uncertain, undetermined; indefinite, vague; undecided.
2. Lit: Unlimited, infinite."
iontaofa	trustworthy, reliable
ocrach	hungry
neamhurchóideach	(adjective) harmless, inoffensive.
leithleach	(adjective) apart, peculiar, or distinct; (noun) a stand-offish or distant person; (legal term) refers to several covenants or jointly and severally; (adjective) selfish or egotistic.
comhfhiosach	(adjective) aware or conscious of something.
doicheallach	(adjective) churlish, inhospitable; (verb) to be unwilling to receive someone; (verb) to be churlish with someone; (verb) to be grudging with something, unwilling to do something; (noun) churlish, cold welcome; (noun) grudging word, smile; (phrase) he gave it grudgingly; (phrase) he is stand-offish in company.
éifeachtúil	(adjective) having the ability to produce a desired effect or result.
cáiréiseach	(adjective) careful; (adjective) nice, delicate.
eitneach	(adjective) relating to a particular ethnic group.
groí	(adjective) strong, vigorous, hearty; (adjective) strange.
dlisteanach	legitimate
súgach	(noun) sea-bream; (adjective) mellow with drink, merry, tipsy; (adjective) cheerful, happy.
tur	dry
ionadach	(adjective) substitute or vicarious; (adjective) out of the way or inaccessible.
tánaisteach	(adjective) secondary; (noun) secondary evidence.
measúil	respectful
maslach	(adjective) insulting or abusive; (noun) an insulting remark or term of reproach; (adjective) overstrenuous or taxing; (noun) heavy or taxing work; (verb) to over-exert oneself or abuse one’s energies.
íosta	(adjective) minimum or minimal.
lúfar	(adjective) agile, active, athletic; (adjective) lithe and agile; (adjective) active and strong.
clárach	(noun) a broad-faced person; (adjective) made of boards or wooden; (adjective) flat or broad in surface features; (adjective) splay in terms of feet.
taobhach	(noun) giddiness or staggers; (adjective) lateral; (adjective) trusting; (adjective) partial or biased.
crochta	(1) hung, hanged; (2) raised; (3) overhanging, steep; (4) hanging down; (5) taken up with something; (6) affected speech
beathach	(1) alive and active
seolta	(1) well-directed; (2) smooth-running, flowing, free; (3) easy, graceful; (4) skilful, adept (at); (5) satisfied, pleased, content
meánach	(1) middle, intermediate; (2) medium, average; (3) moderate
príomhúil	(1) primary; (2) principal; (3) chief
seoigh	(1) wonderful; (2) great; (attrib.) (3) a great day's fun
sóivéadach	(1) Soviet
meisciúil	drunken
mothálach	(1) sensitive, responsive
gallda	(1) foreign; (2) English, Anglicized
aigéadach	Acid, acidic.
roghnach	(1) optional, facultative
éirimiúil	intelligent
meicniúil	(1) mechanical
rite	(1) taut, tense; (2) sharp, steep; (3) exposed (to); (4) eager (for); (5) exhausted, extinct
feidhmiúil	(1) functional; (2) capable, efficient; (3) forceful, strong
ceannasach	(1) ruling, sovereign; (2) commanding, masterful; (3) forward, self-assertive, bold, assured; (4) dominant
ciorclach	(1) circular; (2) cyclic in geometry
saonta	(1) naive; (2) gullible
fuarchúiseach	(1) cool, imperturbable; (2) chilly, frigid; (3) apathetic, indifferent
mórálach	(1) proud; (2) boastful; (3) vain; (phrase) proud of something; (phrase) vain of her beauty; (phrase) delighted with her dress.
bruite	(1) fiery; (2) mean, good for nothing
íogair	(1) sensitive, delicate; (2) ticklish, touchy; (a) airy, lofty; (b) eerie, solemn
cráite	(1) agonized, tormented, grieved
banda	(1) womanly; (2) feminine
fann	(1) faint, weak, languid
cantalach	Plaintive; peevish, querulous.
sciobtha	fast
aclaí	agile
geanúil	affectionate
allúrach	1. Foreigner.
baininscneach	 Gram: Feminine.
teasaí	"1. Hot, warm.
2. Ardent, passionate.
3. Hot, feverish.
4. Hot-tempered, fiery."
aduain	Strange, unfamiliar; apart.
fealltach	treacherous
bagrach	1. Threatening, menacing.
fáilteach	welcoming
dóighiúil	fine-looking
ballach	spotted
athartha	paternal, ancestral
éadóchasach	hopeless
diail	Devilish; terrible, remarkable, wonderful.
airdeallach	1. Alert, watchful.
carthanach	charitable
míshuaimhneach	uneasy; restless
goilliúnach	"1. Painful, distressing, hurtful to feelings.
2. Easily hurt, sensitive."
léanmhar	sorrowful
tearc	rare
bailí	valid
coinníollach	conditional
aonraic	Solitary; alone.
biorach	sharp
calma	calm
crosta	cross
aicmeach	1. Generic. 2. Class.
amaitéarach	amateur
ceanndána	[ceann] + [dána] = stubborn
anróiteach	1. Severe, inclement; distressing.
tintrí	thunderous
ardnósach	1. Grand, pompous; formal.
falsa	false; lazy
ainmhíoch	1. Animal, brutish. 2. Biol: Faunistic.
araltach	1. Heraldic.
sothuigthe	[so-] + [VA-tuig] = understandable
ionúin	Dear, beloved.
gnaíúil	attractive
aislingeach	Visionary; dreamy.
athraitheach	1. Changeable; movable; variant.
mírialta	[mí-] + [rialta] = irregular
codlatach	sleepy
tarcaisneach	contemptuous
ádhúil	1. Lucky, fortunate.
aontaobhach	1. Unilateral.
áthasach	1. Glad, joyful.
aonaránach	1. Alone, solitary.
anamúil	1. Lively, spirited.
aigeanta	"Lit: Natural.
Spirited, cheerful."
deisbhéalach	eloquent
gaofar	windy
colgach	irritable
caifeach	coffee-colored
altach	1. Articulate, jointed. 2. Knotty. 3. Undulating; 4. wavy.
leanbaí	"1. Child-like, innocent.
2. Childish. (a) Puerile. (b) Doting."
céillí	sensible
féarmhar	grassy
gaelach	1. Irish. 2. Attached to Irish, to Irish culture. 3. (Usually with lower-case initial)(a) Native to Ireland. (b) Homely, pleasant. (c) Common, ordinary.
críochnaithe	[VA-críochnaigh] = finished
tomhaiste	[VA-tomhais] = measured
margaíoch	commercial
siamsaíoch	entertaining
iodálach	Italian
inmhianaithe	Desirable.
diaganta	godly, pious
amscaí	Untidy; awkward.
amplach	1. Hungry. 2. Greedy.
dochrach	harmful
cleasach	cunning
stadach	hesitant
graosta	vulgar
bómánta	Slow of perception, slow-witted.
mímhúinte	[mí-] + [múinte] = Unmannerly, rude, ill-bred.
aspalda	apostolic
díonach	Protective; impermeable, proof.
meata	timid
aimrid	Barren, sterile.
deisiúil	skillful
broghach	foul-smelling
ámharach	1. Lucky, fortunate.
spadánta	lazy
airgeadúil	1. Silvery. 2. Financial. 3. Moneyed; profitable.
aonchineálach	1. Homogeneous.
atmaisféarach	1. Atmospheric(al).
Artach	Arctic.
féiltiúil	festive
postúil	official
ainmniúil	1. Nominal. 2. Noted, well-known.
baistí	Baptismal.
briotach	speckled
piseogach	superstitious
adharcach	Horned; horny.
antráthach	1. Late, untimely.
fiata	wild
déistineach	disgusting
aindleathach	1. Illegal.
aistreánach	1. Out of the way, inconvenient. 2. Rugged. 3. Migratory.
aerga	aerial, ethereal
alcaileach	1. Alkaline.
bratógach	patchy
cotúil	Bashful, shy.
armúrtha	Armoured, armour-clad.
faillíoch	negligent
alpach	1. Voracious, greedy. 2. Grabbing.
ainglí	angelic
aistreach	1. Journeying, roving; restless, unsettled. 2. Out of the way, inconvenient. 3. Transitive.
ceathach	showery
ainsealach	1. Chronic.
anacair	1. Uneven, unsteady. 2. Uneasy, uncomfortable. 3. Difficult.
anacrach	1. Distressed. 2. Distressing.
bainniúil	1. Milky. 2. Milk-yielding.
deaslámhach	dexterous
anásta	"1. Needy.
2. Clumsy, awkward."
tíoránta	tyrannical
uiscedhíonach	waterproof
áitithe	1. Established, confirmed, practised.
andúchasach	1. Non-native, foreign; exotic.
aoibhiúil	1. Pleasant, smiling.
aigéanach	1. Oceanic.
áititheach	1. Persuasive.
aranta	Irritable, ill-humoured.
absalóideach	absolute
aimlithe	1. Sodden, spoiled by rain. 2. Wretched. 3. Enfeebled, puny. 4. Mawkish, rendered tasteless.
ainrianta	1. Unbridled, unruly. 2. Licentious.
báiteach	1. Watery. 2. Pale, wan. 3. Pastel. 4. (of cards) Faced.
agóideach	1. Objecting, protesting. 2. Cantankerous.
ainbhiosach	1. Ignorant; stupid.
ainmhianach	1. Passionate, lustful.
aistritheach	1. Movable.
fadsaolach	long-lived
athfhillteach	1. Recurring, recurrent. 2. Reflexive. 3. Reflex.
abartha	witty; Given to repartee
atuirseach	1. Weary; dejected.
cúiseach	Well-mannered; prim, demure.
adhfhuafar	[ad-] + [fuafar] = Horrible, abominable.
aingiallta	1. Irrational. 2. (Of person) Unreasoning, rough.
bách	Affectionate.
fuafar	Hateful, hideous, odious
aithríoch	penitent
anghrách	Erotic.
antoisceach	extreme
acrach	Handy, useful; convenient.
aiféalach	1. Regretful, sorrowful. 2. Shamefaced, shy.
ainmheasartha	[ain-] + [measartha] =  Immoderate, intemperate.
astaróideach	asteroid-related
comharsanúil	neighborly
garach	neighborly
aiteasach	1. Pleasant, joyful.
antaiseipteach	1. Antiseptic.
arúil	1. Fertile, arable.
ainrialta	[ain-] + [rialta] = Undisciplined, disorderly; anarchical.
ainspianta	Grotesque; abnormal.
aonta	1. One. 2. Simple. 3. Single.
aibítreach	1. Alphabetical.
ainneonach	1. Involuntary.
Antartach	Antarctic
ábhailleach	Playful, mischievous.
ainscianta	Wild, furious.
antaibheathach	antibacterial, related to bacteria prevention
artaireach	1. Arterial.
ailléirgeach	1. Allergic.
aimhrialta	[?aimh-] + [rialta] = irregular; anomalous
antlásach	1. Greedy, covetous.
baictéarach	1. Bacterial.
amadánta	Foolish; fatuous
aontaitheach	1. Assenting, agreeing.
aindiaga	[ain-] + [diaga] = godless; impious
amhlánta	Boorish; doltish.
apacailipteach	1. Apocalyptic.
atáirgeach	1. Reproductive.
bachallach	1. Crooked, hooked. 2. Curled, ringleted. 3. Circinate.
aithriúil	1. Fatherly.
anuasal	[an-] + [uasal] = Low-born, ignoble.
aicearrach	1. Short.
aithriseach	 1. Imitative; mocking. 2. Mimetic.
anchumtha	[an-] + [VA-cum] = misshapen
súgrach	Playful
ábhal	Great, immense.
aerachtúil	eerie
aibhseach	1. Great, immense. 2. High.
aithiseach	1. Defamatory; shameful.
armónach	1. Harmonic.
acaointeach	Plaintive, doleful. 
aerdhíonach	air-tight
aighneasach	1. Argumentative; talkative.
béaltirim	[béal] + [tirim] = Dry-lipped, parched.
aiséitiúil	ascetic
neamh-mhaorga	[neamh-] + [maorga] = Unimposing, undignified.
tarnocht	[tar-] + [nocht] = (Stark) naked.
gnéitheach	1. Pertaining to species, specific. 2. Pertaining to features; of good appearance.
ealaionta	artistic
compordúil	comfortable
mí-aigeanta	Dispirited
éalangach	Flawed, defective; weak, debilitated. 
scifleogach	flippant
imeachtach	Going, moving, travelling; speedy.
samhaliteach	imaginary
gáireach	Laughing, smiling.
gaothach	windy
aeistéitiúil	aesthetic, relating to beauty
rabhach	forewarning; premonitory
Is baolach go	it is to be feared that
Dhaid	Dad
a Mham	Mom
sin an méid	that's all
an-	very
chlár éadain	forehead
thar	over; more than
dul thar fóir	go too far
ach	but
síos	down
uaidh	from his; of his
scáthlán	shelter; a screen
in ainneoin	in spite of
